单词	音标	释义
abdicate	[ 'æbdikeit ]	v.放弃，丢弃
abnormal	[ æb'nɔ:ml ]	adj.反常的
abolish	[ ə'bɔliʃ ]	v.取消，废除
absenteeism	[ æbsən'ti:izəm ]	n.旷工，旷课
absorb	[ əb'zɔ:b ]	v.吸收；同化
abstract	[ 'æbstrækt ]	adj.抽象的； n.摘要
absurd	[ əb'sə:d ]	adj.荒唐的
abundant	[ ə'bʌndənt ]	adj.大量的，丰富的；富裕的；多的
academic	[ ,ækə'demik ]	adj.学院的；学术的； n.学者
accelerate	[ ək'seləreit ]	v.加速，促进
access	[ 'ækses ]	n.通路；接近（或进入）的权利；途径
accommodate	[ ə'kɔmədeit ]	v.供给（某人）住宿；使适应；考虑
accompaniment	[ ə'kʌmpənimənt ]	n.伴奏
accord	[ ə'kɔ:d ]	v.同意，一致； n.协议
accordingly	[ ə'kɔ:diŋli ]	adv.因此；相应地
accountant	[ ə'kauntənt ]	n.会计人员，会计师
accretion	[ ə 'kri:ʃn ]	n.增长；增加物
accrue	[ ə'kru: ]	vi.自然增长，自然产生
accumulate	[ ə'kju:mjuleit ]	v.积累；堆积
accuracy	[ 'ækjurəsi ]	n.准确（性），精确（性）
accurate	[ 'ækjurət ]	adj.正确的；精确的
accustomed	[ ə'kʌstəmd ]	adj.习惯的，适应的
acquire	[ ə'kwaiə ]	v.取得，获得
acreage	[ 'eikəridʒ ]	n.英亩数
activate	[ 'æktiveit ]	v.使活动，激活
acute	[ ə'kju:t ]	adj.灵敏的；严重的
adapt	[ ə'dæpt ]	v.（使）适合，适应
addict	['ædikt ]	n.有瘾的人
addict	[ ə'dikt ]	v.使上瘾，使入迷
additive	[ 'æditiv ]	adj.附加的； n.添加剂
adept	[ ə'dept ]	adj.精通的，内行的
adhere	[ əd'hiə ]	v.粘附；遵守，坚持
adjacent	[ ə'dʒeisnt ]	adj.邻近的，毗连的
adjust	[ ə'dʒʌst ]	v.调节，改变…以适应
administer	[ əd'ministə ]	v.管理，执行；用药
admit	[ əd'mit ]	v.承认；准许…进入
adolescent	[ ,ædə'lesnt ]	n.青少年； adj.青春期的
adoption	[ ə'dɔpʃn ]	n.采用，采纳；收养
advent	[ 'ædvənt ]	n.到来，出现
adverse	[ 'ædvə:s ]	adj.逆的，不利的
advocate	[ 'ædvəkeit ]	v.提倡，支持
advocate	[ 'ædvəkət ]	n.支持者，提倡者
aerodynamic	[ ,ɛərəudai'næmik ]	adj.空气动力学的
affirmative	[ ə'fə:mətiv ]	adj.肯定的；n.肯定语
afflict	[ ə'flikt ]	v.使痛苦，折磨
affluent	[ 'æfluənt ]	adj.富裕的
aftermath	[ 'ɑ:ftəmæθ ]	n.结果，后果
aggregate	[ 'ægrigət, 'ægrigeit ]	n.集合体；adj.合计的，聚合的
aggression	[ ə'greʃn ]	n.侵略，侵犯；敌对行为
agrarian	[ ə'grɛəriən ]	adj.土地的；农业的
ailment	[ 'eilmənt ]	n.（不严重的）疾病
ale	[ eil ]	n.淡色啤酒
alga	[ ælgə ]	n.水藻，海藻   (pl. algae)
alien	[ 'eiliən ]	n.外国人
allay	[ ə'lei ]	v.减轻，缓和
allege	[ ə'ledʒ ]	v.断言，宣称
allegiance	[ ə'li:dʒəns ]	n.忠诚，拥护
allergy	[ 'ælədʒi ]	n.过敏症
alleviate	[ ə'li:vieit ]	v.减轻，缓和
alligator	[ 'æligeitə ]	n.短吻鳄（产于美洲的一种鳄鱼）
allocate	[ 'æləkeit ]	v.分配；分派
allowance	[ ə'lauəns ]	n.允许；津贴，补助费
allude	[ ə'lju:d ]	v.间接提到，暗指
alluvial	[ ə'lu:viəl ]	adj.冲积的，淤积的
ally	[ ə'lai ]	v.（使）结盟
ally	[ 'ælai ]	n.同盟者，同盟国
alpha	[ 'ælfə ]	n.希腊语字母表的第一个字母
alter	[ 'ɔ:ltə ]	v.改变，变更
alternate	[ ɔ:l'tə:nət]	adj.交替的，更迭的
alternate	['ɔ:ltəneit ]	v.交替，轮流
altitude	[ 'æltitju:d, æl'titu:d  ]	n.高度
altruism	[ 'æltruizəm ]	n.利他主义，无私
aluminum	[ ə'lu:minəm]	n.铝
alumna	[ ə'lʌmnə ]	n.女校友，女毕业生
alumnus	[ ə'lʌmnəs ]	n.男校友，男毕业生
amalgam	[ ə'mælgəm ]	n.混合物
amass	[ ə'mæs ]	v.积聚
amateur	[ 'æmətə, 'æmətjuə ]	n.业余爱好者
amber	[ 'æmbə ]	n.琥珀
ambiguity	[ ,æmbi'gju:əti ]	n.模棱两可，模糊
单词	音标	释义
ambiguous	[ æm'bigjuəs ]	adj.意义不明的，模棱两可的
ambivalent	[ æm'bivələnt ]	adj.有矛盾看法的
amenable	[ ə'mi:nəbl ]	adj.顺从的；易作出响应的；可按照…处理的
amend	[ ə'mend ]	v.修订；改进
amenity	[ ə'mi:nəti, ə'menəti ]	n.方便设施
amino acid	[ ə,minau 'æsid ]	n.氨基酸，氨酸
ample	[ 'æmpl ]	adj.丰富的，充足的
amplify	[ 'æmplifai ]	v.增强（声音等）；详述
amplitude	[ 'æmpli,tju:d] 	n.广度；震幅         [US'æmpli,tu:d]
anaerobic	[ ,æneə'rəubik ]	adj.厌氧的
analog(ue)	[ 'ænəlɔg, 'ænəlɔ:g ]	n.类似物
analogy	[ ə'nælədʒi ]	n.类推；类比
analytic(al)	[ ,ænə'litik(l) ]	adj.分析（法）的
anatomy	[ ə'nætəmi ]	n.解剖；解剖学
ancestor	[ 'ænsestə ]	n.祖先
ancestry	[ 'ænsestri ]	n.祖先；世系，血统
anecdotal	[ ,ænek'dəutl ]	adj.轶事的
anesthesia	[ ,ænis'θi:ziə ]	n.麻醉（=美 anaesthesia）
animate	[ 'ænimeit ]	v.绘制（动画片）
animosity	[ ,æni'mɔsəti ]	n.憎恶，仇恨
anole	[ə’nəuli]	n.变色龙，避役（产于美洲的蜥蜴类）
anomaly	[ ə'nɔməli ]	n.异常，反常
anonymous	[ ə'nɔniməs ]	adj.匿名的
answerable	[ 'ɑ:nsərəbl ]	adj.应负责的
antagonism	[ æn'tægənizəm ]	n.对抗，敌对
antedate	[ ,ænti'deit ]	v.早于，先于
anterior	[ æn'tiəriə ]	adj.先前的；前面的
anthropologist	[ ,ænθrə'pɔlədʒist ]	n.人类学家
antibiotic	[ ,æntibai'ɔtik ]	n.抗生素
antibody	[ 'ænti,bɔdi ]	n.抗体（身体中的抗病物质）
anticipate	[ æn'tisipeit ]	v.预见，预期
antifreeze	[ 'antifri:z ]	n.抗冻剂
antiquated	[ 'æntikweitid ]	adj.过时的
antique	[ æn'ti:k ]	adj.古时的，古老的； n.古董
antiquity	[ æn'tikwəti ]	n.古代
antitrust	[ ,ænti'trʌst ]	adj.反托拉斯的，反垄断的
apiece	[ ə'pi:s ]	adv.每个，每人，各
apparatus	[ ,æpə'reitəs ]	n.仪器，设备
apparel	[ ə'pærəl ]	n.衣服，服饰
apparent	[ ə'pærənt ]	adj.显然的，明显的；表面上的
appeal	[ ə'pi:l ]	n.呼吁；吸引力；v.吸引；上诉
appetite	[ 'æpitait ]	n.食欲；欲望
appliance	[ ə'plaiəns ]	n.用具，用品
applicable	[ 'æplikəbl ]	adj.适用的，适宜的
appoint	[ ə'pɔint ]	v.任命，指派
apportion	[ ə'pɔ:ʃn ]	v.（按比例或计划）分配
apprentice	[ ə'prentis ]	n.学徒，初学者
approbation	[ ,æprə'beiʃn ]	n.赞成，同意
appropriate	[ ə'prəupriət ]	adj.适当的，相称的
appropriation	[ ə,prəupri'eiʃn ]	n.拨款
approve	[ ə'pru:v ]	v.赞成；批准，认可
approximate	[ ə'prɔksimeit ]	v.接近
approximate	[ ə'prɔksimət ]	adj.近似的，大概的
aquarium	[ ə'kwɛəriəm ]	n.水族馆；养鱼池
aquatic	[ ə'kwætik ]	adj.水的，与水有关的
arable	[ 'ærəbl ]	adj.可耕的
arbitrary	[ 'ɑ:bitrəri, 'ɑ:bitreri ]	adj.任意的，主观的
arch	[ ɑ:tʃ ]	adj.调皮的，淘气的
archeology	[ ,ɑ:ki'ɔlədʒi ]	n.考古学
archenemy	[ ,ɑ:tʃ'enəmi ]	n.天敌；主要敌人
architect	[ 'ɑ:kitekt ]	n.建筑师，设计师
ardent	[ 'ɑ:dnt ]	adj.热心的，热烈的
arid	[ 'ærid ]	adj.干旱的
aristocracy	[ ,æris'tɔkrəsi ]	n.贵族政府，贵族统治
arithmetic	[ ə'riθmətik ]	n.算术
array	[ ə'rei ]	v.排列；n.大批
artery	[ 'ɑ:təri ]	n.【医】动脉
arthritis	[ ɑ:'θraitis ]	n.关节炎
articulate	[ ɑ:'tikjuleit ]	v.清楚地表达
articulate	[ ɑ:'tikjulət ]	adj.善于表达的
artifact	[ 'ɑ:tifækt ]	n.手工艺器物；文物
artificial	[ ,ɑ:ti'fiʃl ]	adj.人工的，人造的
artisan	[ ,ɑ:ti'zæn, 'ɑ:tizn ]	n.手工业工人，手艺人
ascending	[ ə'sendiŋ ]	adj.上升的
ascribe	[ ə'skraib ]	v.归于，归因于
aspersion	[ ə'spə:ʃn, ə'spə: ʒn ]	n.诽谤，中伤
aspiration	[ ,æspə'reiʃn ]	n.志向，抱负
assemble	[ ə'sembl ]	v.集合；装配
单词	音标	释义
assert	[ ə'sə:t ]	v.断言；声称
assess	[ ə'ses ]	v.估价，评价
asset	[ 'æset ]	n.资产，财产
assign	[ ə'sain ]	v.指派；分配；归于
assume	[ ə'sju:m, ə'su:m ]	v.假定，假设；担任…的职位
asthma	[ 'æsmə, 'æzmə ]	n.哮喘
astronomy	[ ə'strɔnəmi ]	n.天文学
attain	[ ə'tein ]	v.达到，完成；获得
attorney	[ ə'tə:ni ]	n.律师
attribute	[ ə'tribju:t, 'ætribju:t ]	n.属性，品质； v.把…归于
attrition	[ ə'triʃn ]	n.人员耗损（逐渐的、正常的人员的减少，如退休或死亡）
auction	[ 'ɔ:kʃn ]	n.拍卖
audit	[ 'ɔ:dit ]	n.审计
aura	[ 'ɔ:rə ]	n.（人或物发出的）气味，香味
aurora	[ ɔ:'rɔ:rə ]	n.极光
austere	[ ɔ:'stiə ]	adj.严格的，节制的
authenticate	[ ɔ:'θentikeit ]	v.证明…是真的
authority	[ ɔ:'θɔrəti ]	n.权利；[pl.]当局，权威
authorize	[ 'ɔ:θəraiz ]	v.授权；批准，认可
automate	[ 'ɔ:təmeit ]	v.（使）自动化
autonomy	[ ɔ:'tɔnəmi ]	n.自治；自主（权）
availability	[ ə,veilə'biləti ]	n.可用性
aversion	[ ə'və:ʃn, ə'və:ʒn ]	n.厌恶，反感
aviator	[ 'eivieitə ]	n.飞行家，飞行员
avidly	[ 'ævidli ]	adv.渴望地，热心地
backwater	[ 'bækwɔ:tə ]	n.死水
bacterium	[ bæk'tiəriəm ]	n.细菌  [pl. bacteria]
balcony	[ 'bælkəni ]	n.阳台；包厢，楼座
ballistic	[ bə'listik ]	adj.弹道的，发射的
bankruptcy	[ 'bæŋkrʌptsi ]	n.破产，倒闭
bar	[ bɑ: ]	v.禁止，阻止； n.棒，酒吧
bark	[ bɑ:k ]	n.树皮（无复数）
barracks	[ 'bærəks ]	n.兵营
barrel	[ 'bærəl ]	n.桶； vt.把…装桶
barren	[ 'bærən ]	adj.没有的，缺乏的
barrier	[ 'bæriə ]	n.栅栏；障碍，壁垒
battalion	[ bə'tæliən ]	n.军营，军队
bead	[ bi:d ]	n.小珠子
beam	[ bi:m ]	n.（光线等的）束，柱
bearer	[ 'bɛərə ]	n.生育者
beckon	[ 'bekən ]	v.吸引，引诱
beehive	[ 'bi:haiv ]	n.蜂窝，蜂箱
bellows	[ 'beləuz ]	n.风箱
benchmark	[ 'bentʃ,mɑ:k ]	n.基准；v.标准测试
benefactor	[ 'benifæktə ]	n.行善者，捐助者
bestow	[ bi'stəu ]	v.放置；授予
betrayal	[ bi'treiəl ]	n.背叛
better-off	[ 'betər'ɔf]	adj.近况较好或较富裕
beverage	[ 'bevəridʒ ]	n.饮料
bias	[ 'baiəs ]	n.偏见；偏心； v.使有偏见
bicker	[ 'bikə ]	v.争吵，争论
bid	[ bid ]	n.出价，投标；投标的价格
bifurcation	[,baifə 'keiʃn ]	n.分歧
bilateral	[ ,bai'lætərəl ]	adj.双边的
billing	[ 'biliŋ ]	n.营业额
bind	[ baind ]	v.捆绑；结合；约束
biodegradable	[ ,baiəudi'greidəbl ]	adj.可由生物降解的
biography	[ bai'ɔgrəfi ]	n.传记
biosphere	[ 'baiəsfiə ]	n.生物圈
bisect	[ bai'sekt ]	v.平分
bizarre	[ bi'zɑ: ]	adj.奇异的，古怪的
blackout	[ 'blækaut ]	n.无线电通讯中断，信号消失
bland	[ blænd ]	adj.（指人）温和的
blast	[ blɑ:st, blæst ]	n.爆炸
bloc	[ blɔk ]	n.集团，组织
block	[ blɔk ]	v.阻碍；堵塞； n.街区
blot	[ blɔt ]	n.墨迹，污迹；vi.模糊，遮暗
bluntly	[ 'blʌntli ]	adv.坦率地，率直地
boardinghouse	[ 'bɔ:diŋhaus ]	n.寄宿公寓
bold	[ bəuld ]	adj.勇敢的，大胆的
bolster	[ 'bəulstə ]	v.支持；鼓励
bolt	[ bəult ]	n.螺栓；雷电
bona fide	[ ,bəunə 'faidi ]	adj.可信的；真诚的，真实的
bond	[ bɔnd ]	n.结合；债券； v.（使）结合
bonus	[ 'bəunəs ]	n.奖金，红利
单词	音标	释义
boom	[ bu:m ]	v.迅速发展；兴旺；n.繁荣
boomerang	[ 'bu:məræŋ ]	n.回飞棒，自食其果的言行
boost	[ bu:st ]	v./n.推，举；促进；吹捧
booth	[ bu:ð, bu:θ ]	n.（隔开的）小房间
bounce	[ bauns ]	v.（使）弹起，（使）反弹； n.（球）弹起
bound	[ baund ]	v.包围，限制； adj.必定的；密切关联的
bounty	[ 'baunti ] 	n.奖金，赏金
boycott	[ 'bɔikɔt ]	v./n.联合抵制
brace	[ breis ]	v.准备
brass	[ brɑ:s ]	n.黄铜
brew	[ bru: ]	v.酿造；冲泡（茶、咖啡等）
bring about	[ briŋ'əbaut]	使发生，导致
brochure	[ 'brəuʃə; brəu'ʃuə ]	n.小册子；说明书
broker	[ 'brəukə ]	n.经纪人
brokerage	[ 'brəukəridʒ ]	n.经纪业，中间人业务；佣金，回扣
bronze	[ brɔnz ]	n.青铜
brutal	[ 'bru:tl ]	adj.残忍的
bucolic	[ bju:'kɔlik ]	adj.乡村的；田园风味的
budget	[ 'bʌdʒit ]	n.预算
buffer	[ 'bʌfə ]	n.缓冲物
bulge	[ bʌldʒ ]	v.膨胀，凸出
bulk	[ bʌlk ]	n.主体，绝大部分
burden	[ 'bə:dn ]	n.负担；v.加重压于
bureau	[ 'bjuərəu, bju'rəu ]	n.（政府机构的）局，部，处
burglarize	[ 'bə:gləraiz ]	v.破门盗窃
burrow	[ 'bʌrəu ]	n.洞穴； v.挖洞
buttress	[ 'bʌtris ]	v.支持
bygone	[ 'baigɔn ]	adj.以前的；过时的
bylaw	[ 'bailɔ: ]	n.地方法规；规章制度
cabin	[ 'kæbin ]	n.（船、机）舱
cabinet	[ 'kæbinit ]	n.贮藏厨，陈列柜
caffeine	[ 'kæfi:n ]	n.咖啡因
calculate	[ 'kælkjuleit ]	v.计算；估计；推测
calefaction	[ ,kæli'fækʃən ]	n.加热；发暖作用
calf	[ kɑ:f; kæf ]	n.牛犊，幼崽
calligraphic	[ ,kæli'græfik ]	adj.书法的，书写的
campaign	[ kæm'pein ]	n.战役；系列活动
candidate	['kændidət, 'kændideit]	n.候选人；投考者
cannon	[ 'kænən ]	n.加农炮，大炮
canopy	[ 'kænəpi ]	n.顶棚；树冠层
capacity	[ kə'pæsəti ]	n.最大容量；最大生产量；能力
capitalize	[ 'kæpitəlaiz ]	v.资本化；获利；利用
capsule	[ 'kæpsju:l; 'kæpsl ]	n.胶囊
captivate	[ 'kæptiveit ]	v. 迷住，迷惑，吸引
captive	[ 'kæptiv ]	n.俘虏
capture	[ 'kæptʃə ]	v.捕捉；占领；吸引，赢得
carbohydrate	[ ,kɑ:bəu'haidreit ]	n.碳水化合物，糖类
carcass	[ ,kɑ:kəs ]	n.（屠宰后）畜体，（人的）身躯
carcinogen	[ kɑ:'sinədʒen ]	n.致癌物
cardiac	[ 'kɑ:diæk ]	adj.心脏的；心脏病的
cardiovascular	[ ,kɑ:diəu'væskjulə ]	adj.心血管的
cargo	[ 'kɑ:gəu ]	n.货物
carnivore	[ 'kɑ:nivɔ: ]	n.肉食动物
cartel	[ kɑ:'tel ]	n.卡特尔（为协调生产、价格和商品市场而组成的独立的商业组织联合体）
cascade	[ kæ'skeid ]	n.小瀑布
caseload	[ 'keisləʊd ]	n.办案量
caste	[ kɑ:st; kæst ]	n.社会等级制度；社会团体
casualty	[ 'kæʒuəlti ]	n.伤亡（人）；[pl.]伤亡人数
cataclysmic	[ ,kætə'klizmik ]	adj.大变动的
catalogue	[ 'kætəlɔg, 'kætəlɔ:g ]	n.商品目录； v.为…编目录
catalyst	[ 'kætəlist ]	n.催化剂；促使事物发展的因素
catastrophe	[ kə'tæstrəfi ]	n.灾难，灾祸
categorical	[ ,kætə'gɔrikl;	adj.无条件的，绝对的；分类的
	,kætə'gɔ:rikl ]	
category	[ 'kætə,gəri, 'kætəgɔ:ri ]	n.类别，种类
cater	[ 'keitə ]	v.满足（需要）
caterpillar	[ 'kætə,pilə ]	n.毛虫
cathedral	[ kə'θi:drəl ]	n.大教堂； adj.大教堂的
Catholic	[ 'kæθəlik ]	adj.罗马天主教的
causative	[ 'kɔ:zətiv ]	adj.成为原因的
cease	[ si:s ]	v./ n.终止，停止
celestial	[ si'lestiəl, si'lestʃl ]	adj.天体的，天空的
cellular	[ 'seljulə ]	adj.细胞的；蜂窝状的
census	[ 'sensəs ]	n.人口调查，人口普查
centrality	[ sen'træləti ]	n.中心性
ceramic	[ si'ræmik ]	adj.陶的，制陶的
单词	音标	释义
cereal	[ 'siəriəl ]	n.谷类，谷类食品
certificate	[ sə'tifikət ]	n.证券；证明书
certify	[ 'sə:tifai ]	v.保证；证明
certitude	[ 'sə:titju:d, 'sə:titu:d ]	n.确定无疑
cessation	[ se'seiʃn ]	n.停止
chaise	[ ʃeiz ]	n.两轮（或四轮）轻便马车
chalice	[ 'tʃælis ]	n.杯；圣餐杯
chamber	[ 'tʃeimbə ]	n.室，房间； adj.【音】室内的
character	[ 'kæriktə ]	n.性格；特征；字符
characterization	[ ,kærəktərai'zeiʃn ]	n.描述
charity	[ 'tʃæriti ]	n.慈善；慈善团体
chart	[ tʃɑ:t ]	v.记录，记载
charter	[ 'tʃɑ:tə ]	n.租赁；v.租，给予特权
chatty	[ 'tʃæti ]	adj.喜欢唠叨的；话题轻松的
chauvinism	[ 'ʃəuvinizəm ]	n.沙文主义，盲目爱国主义
chip	[ tʃip ]	n.芯片；碎片
chord	[ kɔ:d ]	n.【几何】弦
chore	[ tʃɔ: ]	n.家庭杂务；令人厌烦的工作
choreographer	[ ,kɔ(:)ri'ɔgrəfə ]	n.舞蹈指导
chronic(al)	[ 'krɔnik(l) ]	adj.长期的，慢性的
chronicle	[ 'krɔnikl ]	n.编年史；vt.记录，记载
circuit	[ 'sə:kit ]	n.电路
circular	[ 'sə:kjulə ]	adj.圆形的；环绕的
circulate	[ 'sə:kjuleit ]	v.散布，传播
circumference	[ sə'kʌmfərəns ]	n.圆周；圆周长
circumspect	[ 'sə:kəmspekt ]	adj.谨慎的
circumvent	[ ,sə:kəm'vent ]	v.回避，规避
civic	[ 'sivik ]	adj.城市的；公民的；平民的
claim	[ kleim ]	n.声称；v.声称；认领；索取
clan	[ klæn ]	n.部落，氏族
clandestine	[ klæn'destin ]	adj.秘密的，暗中从事的
clarify	[ 'klærifai ]	v.澄清
clarity	[ 'klærəti ]	n.清楚，明晰
classify	[ 'klæsifai ]	v.分类；归类
clergy	[ 'klə:dʒi ]	n.牧师；神职人员
client	[ 'klaiənt ]	n.委托人；顾客
cliff	[ klif ]	n.悬崖，峭壁
clinging	[ 'kliŋiŋ ]	adj.黏着的
clockwise	[ 'klɔkwaiz ]	adj./adv.顺时针方向（的）
clog	[ klɔg ]	v.妨碍；阻塞
clump	[ klʌmp ]	n.丛，簇； v.使密集
cluster	[ 'klʌstə ]	n.（任何的）群，堆，团； v.使聚集在一起
coalition	[ ,kəuə'liʃn ]	n.结合，联合
coaster	[ 'kəustə ]	n.（供娱乐用的）滑坡铁路
cocaine	[ kəu'kein ]	n.可卡因
code	[ kəud ]	n.法规；习俗，准则
codify	['kəudifai; 'kɔdəfai ]	v.整理（法律）；系统化
cognitive	[ 'kɔgnitiv ]	adj.认知的
coherent	[ kəu'hiərənt ]	adj.附着的，粘在一起的
coinage	[ 'kɔinidʒ ]	n.货币，货币制度
coincide	[ ,kəuin'said ]	v.巧合；一致，符合
collaborate	[ kə'læbəreit ]	v.协作；勾结，通敌
collapse	[ kə'læps ]	v./n.崩溃；失败
collateral	[ kə'lætərəl ]	n.抵押品，担保
collective	[ kə'lektiv ]	adj.集体的
collide	[ kə'laid ]	v.碰撞；抵触
collinear	[ kɔ'linjə ]	adj.在同一直线上的
colossal	[ kə'lɔsl ]	adj.巨大的，庞大的
combat	[ 'kɔmbæt, kəm'bæt ]	n.战斗； v.与…作战；同…斗争；adj.战斗的
combine	[ kəm'bain ]	v.联合，结合
combustion	[ kəm'bʌstʃən ]	n.燃烧
comedian	[ kə 'mi:diən ]	n.喜剧演员
comet	[ 'kɔmit ]	n.彗星
commend	[ kə'mend ]	v.推荐；表扬
commensurate	[ kə'menʃərət ]	adj.相称的；相当的
comment	[ 'kɔment ]	n.评论，意见
commission	[ kə'miʃn ]	n.委员会；佣金；v.委托
commit	[ kə'mit ]	v.做；交付；（使）受约束，致力于
commodity	[ kə'mɔdəti ]	n.商品
commoner	[ 'kɔmənə ]	n.平民
commonplace	[ 'kɔmənpleis ]	adj.平凡的，普通的；n.平庸的东西，陈词滥调
communal	[ 'kɔmjunl ]	adj.全体共用的，共享的
community	[ kə'mju:nəti ]	n.团体；共同体
commute	[ kə'mju:t ]	v.坐公交车往返于两地
compact	[ 'kɔmpækt, kəm'pækt ]	adj.紧密的； n.契约
companionate	[ kəm'pænjənit ]	adj.伙伴的；和睦的
单词	音标	释义
compassion	[ kəm'pæʃn ]	n.同情，怜悯
compatible	[ kəm'pætəbl ]	adj.协调的；兼容的
compel	[ kəm'pel ]	v.强迫
compensate	[ 'kɔmpənseit ]	v.补偿；偿还；付报酬
compensatorily	[ ,kɔmpən'seitərili ]	adv.补偿性地
competence	[ 'kɔmpitens ]	n.能力
compile	[ kəm'pail ]	v.编辑，编撰
complacency	[ kəm'pleisənsi ]	n.自满，自得
complainant	[ kəm'pleinənt ]	n.控诉者；原告
complement	[ 'kɔmplimənt ]	v.补充； n.补足物；【生】（血清中的）补体
complex	[ 'kɔmpleks; kəm'pleks ]	adj.复杂的
comply	[ kəm'plai ]	v.遵循
component	[ kəm'pəunənt ]	n.成分，要素
compose	[ kəm'pəuz ]	v.组成；使安定
compound	[ 'kɔmpaund; kəm'paund ]	n.混合物，化合物； adj.混合的
comprehend	[ ,kɔmpri'hend ]	v.理解，领会
compress	[ kəm'pres ]	v.压缩，浓缩
comprise	[ kəm'praiz ]	v.包含；组成
compromise	[ 'kɔmprəmaiz ]	v.妥协； n.折衷
compulsory	[ kəm'pʌlsəri ]	adj.强制性的；义务的
computation	[ ,kɔmpju:'teiʃn ]	n.计算，估计
conceal	[ kən'si:l ]	v.隐瞒；隐藏
concede	[ kən'si:d ]	v.让步；（不情愿地）承认
conceive	[ kən'si:v ]	v.怀孕；构思，设想
conceptual	[ kən'septʃuəl ]	adj.观念的，概念的
concert	[ 'kɔnsət ]	n.一致；音乐会
concrete	[ 'kɔŋkri:t ]	adj.具体的，有形的； n.混凝土
concurrent	[ kən'kʌrənt ]	adj.同时发生的
condemn	[ kən'dem ]	v.声讨，谴责
condense	[ kən'dens ]	v.使冷凝，浓缩；缩短
condescending	[ ,kɔndi'sendiŋ ]	adj.俯就的，屈尊的；有优越感的
condominium	[ ,kɔndə'miniəm ]	n.共管；公寓公私共有方式
conduct	[kən'dʌkt ]	v.实施，指导；传导
conduct	[ 'kɔndʌkt ]	n.行为
confederation	[ kən,fedə'reiʃn ]	n.同盟，联盟
confer	[ kən'fə: ]	v.讨论；授予
confess	[ kən'fes ]	v.承认，供认
confidential	[ ,kɔnfi'denʃl ]	adj.秘密的
configuration	[ kən,figjə'reiʃn;  kən,figju'reiʃn ]	n.构造；外形；【天】（行星等的）相对位置
confine	[ kən'fain ]	v.限制，禁闭；n. [pl.]界限
confirm	[ kən'fə:m ]	v.证实，使有效；确定
conform	[ kən'fɔ:m ]	v.遵照；符合
confront	[ kən'frʌnt ]	v.面对；面对挑战
Confucian	[ kən'fju:ʃiən ]	adj./n.孔子的；儒家的；儒家学者
congenial	[ kən'dʒi:niəl ]	adj.舒适的
congested	[ kən'dʒestid ]	adj.拥挤不堪的，充塞的
conglomerate	[ kən'glɔmərət ]	n.企业集团
congregation	[ ,kɔngri'geiʃn ]	n.（某地区的）全体教徒
congress	[ 'kɔŋgres; 'kɔŋgris  ]	n.议会，国会；代表大会
conscience	[ 'kɔnʃəns ]	n.良心，是非感
conscription	[ kən'skripʃən ]	n.征兵，征募
consecutive	[ kən'sekjutiv ]	adj.连续的，连贯的
consent	[ kən'sent ]	v.同意，答应
consequence	[ 'kɔnsikwəns; 'kɔnsikwens]	n.结果；重要（性）；推论
conservatively	[ kən'sə:vətivli ]	adv.保守地
conserve	[ kən'sə:v ]	v.保存；节约
consistency	[ kən'sistənsi ]	n.一致性；连接
consortium	[ kən'sɔ:tiəm; kən'sɔ:ʃiəm ]	n. [pl. consortia]协会；联营，集团；财团
conspire	[ kən'spaiə ]	v.阴谋，共谋
constant	[ 'kɔnstənt ]	adj.稳定的，不变的； n.常数，恒量
constellation	[ 'kɔnstə'leiʃən ]	n.星座，星群
constituent	[ kən'stitjuənt ]	n.成分，要素；选民
constitute	[ 'kɔnstitju:t ]	v.组成，建立；制定
constraint	[ kən'streint ]	n.约束，抑制
constrict	[ kən'strikt ]	v.收缩；使狭窄
consult	[ kən'sʌlt ]	v.咨询；参考；商议
consumption	[ kən'sʌmpʃən ]	n.消耗（量）；消费（量）
contaminate	[ kən'tæmineit ]	v.污染；感染
contemplate	[ 'kɔntəmpleit ]	v.打算，预期
contemporary	[ kən'tempərəri;kən'tempəreri]	adj.当代的，同时代的； n.同代人
contemptuous	[ kən'temptʃuəs ]	adj.轻蔑的，傲慢的
contend	[ kən'tend ]	v.与困难作斗争，应付；主张
contiguous	[ kən'tigjuəs ]	adj.接近的，接壤的
contingent	[ kən'tindʒənt ]	adj.有条件的； n.分遣队
contraband	[ 'kɔntrəbænd ]	n.走私；走私货
contract	[ 'kɔntrækt ]	n.合同，契约
contract	[ kən'trækt ]	v.感染
contraction	[ kən'trækʃn ]	n.收缩
单词	音标	释义
contradict	[ ,kɔntrə'dikt ]	v.否定；反驳
control	[ kən'trəul ]	n.（实验的）对照，参照物
controversy	[ 'kɔntrəvə:si ]	n.争论，辩论
convection	[ kən'vekʃn ]	n.对流
conversion	[ kən'və:ʃn; kən'və:ʒn ]	n.转换；折合；财产转移
convert	[ kən'və:t ]	v.（使）转换，（使）改变；换算
convey	[ kən'vei ]	v.运载，运送；表达
conviction	[ kən'vikʃn ]	n.判罪；坚信
convince	[ kən'vins ]	v.（使）某人确信；说服
convoluted	[ 'kɔnvəlju:tid ]	adj.错综复杂的
coordinate	[ kəu'ɔ:dinət; kəu'ɔ:dineit ]	n.坐标； v.协调
copper	[ 'kɔpə ]	n.铜； adj.铜（制）的
coral	[ 'kɔrəl ]	n.珊瑚，珊瑚虫
cord	[ kɔ:d ]	n.绳，索；【解】索状组织
coronary	[ 'kɔrənəri; 'kɔ:rəneri ]	adj.冠状动脉的
corporate	[ 'kɔ:pərət ]	adj.团体的；法人的，公司的
corps	[ kɔ: ]	n.部队
corral	[ kɔ'rɑ:l, kə'ræl ]	v.关进畜栏
correlate	[ 'kɔrəleit; 'kɔ:rəlet ]	v.和…相关
correspond	[ ,kɔri'spɔnd; ,kɔ:rə'spɔnd ]	v.相一致；通信；相应
corroborate	[ kə'rɔbəreit ]	v.支持，证实
corrosion	[ kə'rəuʒən ]	n.腐蚀（状态），侵蚀
corruption	[ kə'rʌpʃn ]	n.腐化，堕落
cortex	[ 'kɔ:teks ]	n.（内部器官的）皮质
cosmetic	[ kɔz'metik ]	n.化妆品
cosmic	[ 'kɔzmik ]	adj.宇宙的
council	[ 'kaunsl ]	n.理事会，委员会
counteract	[ ,kauntə'rækt ]	v.消除，抵消
counterfeit	[ 'kauntəfi(:)t ]	v.伪造（货币等），仿造
countermeasure	[ 'kauntə,meʒə ]	n.对策，对抗手段
counterpart	[ 'kauntəpɑ:t ]	n.相应的人（或物）
countervail	[ 'kauntəveil ]	v.补偿；对抗，抵消
coupon	[ 'ku:pɔn ]	n.赠券；优待券
courier	[ 'kuriə ]	n.送急件的人
courtesy	[ 'kə:təsi ]	n.礼貌，谦恭
cowhide	[ 'kauhaid ]	n.牛皮；牛皮鞭
crack	[ kræk ]	n.强效纯可卡因； v.裂开，断裂
cramped	[ kræmpt ]	adj.狭窄的；狭促的
crass	[ kræs ]	adj.粗俗的，冷酷的
crate	[ kreit ]	n.篮，篓
creativity	[ ,kri:ei'tivəti ]	n.创造力，创作力
credence	[ 'kri:dns ]	n.信任
credit	[ 'kredit ]	v.把…归给；把…记入贷方
creditworthiness	[ 'kredit,wəðinis ]	n.有资格接受信用贷款
crest	[ krest ]	n.顶部
criminology	[ ,krimi'nɔlədʒi ]	n.犯罪学
cripple	[ 'kripl ]	n.瘸子； v.使…成残废
criteria	[ krai'tiəriə ]	n.标准
critic	[ 'kritik ]	n.评论家，批评家
critique	[ kri'ti:k ]	n.评论（文）；v.批判性地讨论
crossbred	[ 'krɔ(:)sbred ]	adj.杂种的
crucial	[ 'kru:ʃl ]	adj.决定性的；至关紧要的
crude	[ kru:d ]	adj.天然的；粗糙的，拙劣的
crusade	[ kru:'seid ]	n.十字军东征，宗教战争
crust	[ krʌst ]	n.地壳
cryptic	[ 'kriptik ]	adj.神秘的；含义模糊的
cube	[ kju:b ]	n.立方体
cue	[ kju: ]	n.暗示，信号
cuisine	[ kwi:'zi:n ]	n.烹饪，烹调法
culminate	[ 'kʌlmineit ]	v.达到顶点
culpability	[ ,kʌlpə'biləti ]	n.有罪，有过失
cult	[ kʌlt ]	n.崇拜
cultivated	[ 'kʌltiveitid ]	adj.耕种的；栽植的；有修养的
cumbersome	[ 'kʌmbəsəm ]	adj.麻烦的
cupidity	[ kju:'piditi ]	n.贪婪，贪心
curb	[ kə:b ]	n.路边； v.控制
currency	[ 'kʌrənsi ]	n.流通；货币
curriculum	[ kə'rikjuləm ]	n.全部课程
curtail	[ kə:'teil ]	v.缩减
customize	[ 'kʌstəmaiz ]	vt.定制，定做
customs	[ 'kʌstəmz ]	n.关税；海关
cutback	[ 'kʌtbæk ]	n.减少，削减
cyclic	[ 'saiklik ]	adj.循环的
cylinder	[ 'silində ]	n.圆柱体
cylindrical	[ si'lindrikl ]	adj.圆柱体的；圆筒形的
cynical	[ 'sinikl ]	adj.愤世嫉俗的
单词	音标	释义
debase	[ di'beis ]	v.降低；降低（硬币）的成色
debate	[ di'beit ]	n./v.辩论，讨论
debris	[ 'deibri:; də'bri: ]	n.碎片，残骸
debunk	[ ,di:'bʌŋk ]	v.揭穿真相；暴露
decade	[ 'dekeid ]	n.十年，十年期
decay	[ di'kei ]	v./n.腐朽；衰退
decimal	[ 'desiml ]	n.小数； adj.小数的；十进制的
decimate	[ 'desimeit ]	v.使（数量）急剧减少
decipher	[ di'saifə ]	v.破译
declension	[ di'klenʃn ]	n.衰退
decorate	[ 'dekəreit ]	v.装饰，点缀
decorous	[ 'dekərəs ]	adj.符合礼节的
dedicated	[ 'dedikeitid ]	adj.专注的；献身的
deduce	[ di'dju:s ]	v.推断
deduct	[ di'dʌkt ]	v.扣除；演绎
deem	[ di:m ]	v.认为；相信
default	[ di'fɔ:lt ]	v.违约；拖欠
defendant	[ di'fendənt ]	n.被告
deferential	[ ,defə'renʃl ]	adj.恭顺的
defiant	[ di'faiənt ]	adj.蔑视的
deficit	[ 'defisit ]	n.赤字
definitive	[ di'finətiv ]	adj.确定的；权威性的
deflect	[ di'flekt ]	v.（使）偏斜，（使）转向
deform	[ di'fɔ:m ]	v.使变形
defrost	[ ,di:'frɔst; ,di:'frɔ:st ]	v.除霜，解冻
degrade	[ di'greid ]	v.降低…的身份；（使）降解；（使）退化
dehydrate	[ ,di:'haidreit ]	v.（使）脱水
deleterious	[ ,deli'tiəriəs ]	adj.（对身心）有害的
deliberate	[ di'libərət ]	adj.深思熟虑的；蓄意的
delicate	[ 'delikət ]	adj.微妙的；精致的；脆弱的
delineate	[ di'linieit ]	v.描画；描绘轮廓
delinquent	[ di'liŋkwənt ]	adj.拖欠的；违法的
delta	[ 'deltə ]	n.（河流的）三角洲
deluxe	[ di'lʌks ]	adj.豪华的
delve	[ delv ]	v.钻研，深入探索
demobilization	['di:,məʊbəlai'zeiʃn ]	n.遣散（军人）；复员
democrat	[ 'deməkræt ]	n.民主主义者；[D~]美国民主党人
demographer	[ di'mɔgrəfə ]	n.人口统计学家
demonstrably	[ 'demənstrəbli; 'dimɔnstrəbli ]	adv.可证明地，显然地
demonstrate	[ 'demənstreit ]	v.证明；显示；示威游行（或集会）
denote	[ di'nəut ]	v.表示，意味着
dense	[ dens ]	adj.密集的；浓厚的
denunciatory	[ di'nʌnsiətəri ]	adj.谴责的
depart	[ di'pɑ:ht ]	v.背离，违反；出发
depict	[ di'pikt ]	v.刻画，描述
deplete	[ di'pli:t ]	v.倒空，耗尽
deposit	[ di'pɔzit ]	v.储蓄；放置； n.存款；押金；沉积物
deprecate	[ 'deprikeit ]	v.反对；藐视
depreciation	[ di,pri:ʃi'eiʃn ]	n.贬值
depress	[ di'pres ]	v.削弱；使萧条
depression	[ di'preʃn ]	n.消沉；萧条（期）
deprivation	[ ,depri'veiʃn ]	n.剥夺；缺乏
derive	[ di'raiv ]	v.得到，得自；推论出
descend	[ di'send ]	v.下降；遗传
description	[ di'skripʃn ]	n.描写，描述
desegregation	[ ,di:segri'geiʃn ]	n.取消种族隔离
deserve	[ di'zə:v ]	v.应受，值得
designate	[ 'dezigneit ]	v.指派；指明，指定
desire	[ di'zaiə ]	v.渴望；要求；n.愿望
despise	[ di'spaiz ]	v.轻视，轻蔑
detach	[ di'tætʃ ]	v.分开，分离
detached	[ di'tætʃt ]	adj.不含个人偏见的
detection	[ di'tekʃn ]	n.察觉；发现
deter	[ di'tə: ]	v.威慑；阻止
deteriorate	[ di'tiəriəreit ]	v.（使）恶化
devastate	[ 'devəsteit ]	v.毁坏
devise	[ di'vaiz ]	v.想出；设计，发明
devoid	[ di'vɔid ]	adj.空的，缺乏的
dexterity	[ deks'teriti ]	n.纯熟，灵巧
diagnose	[ 'daiəgnəuz; ,daiəg'nəus ]	v.诊断
diagonal	[ dai'ægənl ]	n.对角线
dialect	[ 'daiəlekt ]	n.方言，语调
diameter	[ dai'æmitə ]	n.直径
单词	音标	释义
diaper	[ 'daiəpə ]	n.尿布
dichotomy	[ dai'kɔtəmi ]	n.一分为二
dictate	[ dik'teit; 'dikteit ]	v.规定，支配
diesel	[ 'di:zl ]	n.内燃机，柴油机
dietary	[ 'daiətəri; 'daiəteri ]	adj.饮食的
differentiate	[ ,difə'renʃieit ]	v.区别；【生】分化
digest	[dai'dʒest; di'dʒest ]	v.消化；吸收
digit	[ 'didʒit ]	n.数字
dilemma	[ dai'lemə ]	n.困境，左右为难
dilute	[ dai'lju:t; dai'lu:t ]	v.冲淡，稀释
dimension	[ dai'menʃn ]	n.尺度；维；方面
diminish	[ di'miniʃ ]	v.减少，削弱
dinosaur	[ 'dainəsɔ: ]	n.恐龙
dioxide	[ dai'ɔksaid ]	n.二氧化物
diploma	[ di'pləumə ]	n.文凭
diplomatic	[ ,diplə'mætik ]	adj.外交的
dire	[ 'daiə ]	adj.可怕的；悲惨的
disaster	[ di'zɑ:stə; diz'æstə ]	n.灾难；彻底的失败
discard	[ dis'kɑ:d ]	v.扔掉，丢弃
discern	[ di'sə:n ]	v.（费劲）识别，辨认
discharge	[ dis'tʃɑ:dʒ; 'distʃɑ:dʒ ]	v./n.排放；释放
disciple	[ di'saipl ]	n.门徒，弟子
discipline	[ 'disiplin ]	v.训练，调教； n.纪律；学科
discord	[ 'diskɔ:d ]	n.不和，纷争
discount	[ dis'kaunt; 'diskaunt ]	v.忽视；打折； n.折扣
discrepancy	[ dis'krepənsi ]	n.差异；矛盾
discrete	[ di'skri:t ]	adj.个别的；不连续的
discretionary	[ dis'kreʃənəri; dis'kreʃəneri ]	adj.自由决定的；可随意使用的
discriminate	[ di'skrimineit ]	v.歧视；辨别
disdainful	[ dis'deinfl ]	adj.轻蔑的，鄙视的
disenchanted	[ ,disin'tʃɑ:ntid ]	adj.不再着迷的，不抱有幻想的
disenfranchise	[ ,disin'fræntʃaiz ]	v.剥夺…的公民权
disinclined	[ ,disin'klaind ]	adj.不愿的
dislocation	[ ,dislə'keiʃn; ,disləu'keiʃn ]	n.混乱，紊乱
dislodge	[ dis'lɔdʒ ]	v.逐出；去除
dismal	[ 'dizməl ]	adj.凄凉的；暗淡的
dismantle	[ dis'mæntl ]	v.拆除；废除，取消
dismay	[ dis'mei ]	v./n.（使）沮丧
disparaging	[ dis'pæridʒiŋ ]	adj.贬低的，轻蔑的
disparate	[ 'dispərət ]	adj.（种类）全异的；迥然不同的
dispel	[ di'spel ]	v.驱散；消除
dispense	[ di'spens ]	v.分配，分发
disperse	[ di'spə:s ]	v.分散，散布
dispose	[ di'spəuz ]	v.处置；安排
disproportionate	[ ,disprə'pɔ:ʃənət ]	adj.不成比例的
disrupt	[ dis'rʌpt ]	v.扰乱；（使）中断，（使）瓦解
disseminate	[ di'semineit ]	v.传播，散布
dissent	[ di'sent ]	v./n.不同意
dissipate	[ 'disipeit ]	v.（使）消散，（使）消失
dissociate	[ di'səuʃieit ]	v.分离，分开
distill	[ di'stil ]	v.蒸馏；灌输
distinct	[ di'stiŋkt ]	adj.不同的，有差别的
distinguish	[ di'stiŋgwiʃ ]	v.区别，辨清；（使）杰出
distort	[ di'stɔ:t ]	v.弄歪；歪曲
distribute	[ di'stribju:t; 'distribju:t ]	v.分配，分发
district	[ 'distrikt ]	n.地区；行政区
disturb	[ di'stə:b ]	v.打乱，扰乱
diverge	[ dai'və:dʒ ]	v.分开；演变
diverse	[ dai'və:s ]	adj.不同的，多种多样的
divest	[ dai'vest ]	v.（使）摆脱；剥夺
dividend	[ 'dividend ]	n.（股份的）红利；效益；被除数
divisible	[ di'vizəbl ]	adj.可整除的
division	[ di'viʒn ]	n.部门；分裂（繁殖）；区分
divisive	[ di'vaisiv ]	adj.分裂的，不和的
divulge	[ dai'vʌldʒ ]	v.泄露（秘密等）
doctorate	[ 'dɔktərət ]	n.博士学位
doctrine	[ 'dɔktrin ]	n.教义；学说
dogma	[ 'dɔgmə ]	n.教条
domain	[ dəu'mein ]	n.领地，领土
domestic	[ də'mestik ]	adj.本国的；家（庭）的；驯养的
domesticate	[ də'mestikeit ]	v.驯养，教化
dominate	[ 'dɔmineit ]	v.支配；在…占首要地位
donate	[ dəu'neit; 'dəuneit ]	v.捐赠，赠送
dormant	[ 'dɔ:mənt ]	adj.【生】休眠的
dose	[ dəus ]	n.（药的）剂量；一服
单词	音标	释义
dough	[ dəu ]	n.生面团
downplay	[ 'daunplei ]	v.贬低，不予重视
downstream	[ ,daʊn'stri:m ]	adv.顺流而下，朝下游方向
drab	[ dræb ]	adj.土褐色的
dramatize	[ 'dræmətaiz ]	v.（使）戏剧化，渲染
drastic	[ 'dræstik ]	adj.激烈的，剧烈的
drift	[ drift ]	v.漂流，漂移；（价格等）缓慢变动
drizzle	[ 'drizl ]	n.细雨；细流
dropout	[ 'drɔpaut ]	n.<美>中途退学（的学生）
drought	[ draut ]	n.干旱，旱灾
dubious	[ 'dju:bjəs ]	adj.可疑的；不确定的
ductile	[ 'dʌktail, 'dʌktl ]	adj.易变形的；可塑的
dump	[ dʌmp ]	v.倾倒；倾销； n.堆存处
dumpster	['dʌmpstə ]	n.垃圾桶
duplicate	[ 'dju:plikeit; 'du:pləkeit ]	adj.复制的； n.复制品； v.复制；重复
durability	[ ,djuərə'biləti; ,durə'biləti ]	n.经久，耐久性
dwarf	[ dwɔ:f ]	n.矮子； v.（使）变矮小
dwelling	[ 'dweliŋ ]	n.住处，寓所
dye	[ dai ]	n.染料；v.给…染色
dynamic	[ dai'næmik ]	n.动力；[常pl.]动态
ease	[ i:z ]	v.缓和；n.不费力
echolocation	[ ekəʊləʊ'keiʃn ]	n.回声定位法
eclipse	[ i'klips ]	n.（日、月）食；（声誉、地位等的）消失，衰落
ecology	[ i:'kɔlədʒi ]	n.生态学，环境适应学
ecosystem	['i:kəusistəm ]	n.生态系统
edge	[ edʒ ]	n.优势；边（缘）
edible	[ 'edibl ]	adj.可食用的
effect	[ i'fekt ]	v.生效；引起；n.效应；结果
efficiency	[ i'fiʃnsi ]	n.效率，功效
effigy	[ 'efidʒi ]	n.雕像，肖像
effluent	[ 'efluənt ]	n.支流；废水
egalitarianism	[ i,gæli'teəriən izəm ]	n.平等主义
egoistic	[ ,egəʊ'istik; ,i:gəʊ'istik ]	adj.自我主义的，利己主义的
eject	[ i'dʒekt ]	v.喷射
elaborate	[ i'læbərət ]	adj.精心制作的
elaborate	[ i'læbəreit ]	v.详述，详细制定
elective	[ i'lektiv ]	n.选修课； adj.选修的
electorate	[ i'lektərət ]	n.全体选民
electro	[ i'lektrəʊ ]	n.电镀物品，电版
electron	[ i'lektrɔn ]	n.【物】电子
element	[ 'elimənt ]	n.元素，要素
elevate	[ 'eliveit ]	v.抬起；使升高
elicit	[ i'lisit ]	v.引出，引起
eligible	[ 'elidʒəbəl ]	adj.合格的，符合条件的
eliminate	[ i'limineit ]	v.排除，消除
elite	[ ei'li:t, i'li:t ]	n.精英； adj.卓越的，精锐的
elliptical	[ i'liptikl ]	adj.椭圆形的
elongate	[ 'i:lɔŋgeit; i'lɔŋgeit ]	v.延长，伸长
eloquent	[ 'eləkwənt ]	adj.雄辩的
elude	[ i'lju:d, i'lu:d ]	v.逃避（追捕等）
embalm	[ im'bɑ:m ]	v.以香油（或药料）涂尸防腐
embargo	[ im'bɑ:gəu ]	n.禁运（令）
embark	[ im'bɑ:k ]	v.着手，开始做
embarrass	[ im'bærəs ]	v.（使）尴尬
embed	[ im'bed ]	v.嵌入
embellish	[ im'beliʃ ]	v.装饰；润色
embrace	[ im'breis ]	v.拥抱；信奉；接受
embryo	[ 'embriəu ]	n.胚胎
emerge	[ i'mə:dʒ ]	v.浮现；（事实等）暴露
emergency	[ i'mə:dʒənsi ]	n.紧急情况，紧急事件
eminent	[ 'eminənt ]	adj.杰出的；突出的
emission	[ i'miʃn ]	n.（光、热等的）散发
empirical	[ em'pirikl ]	adj.经验主义的，经验的
emulate	[ 'emjuleit ]	v.效仿；努力赶上或超越
enact	[ i'nækt ]	v.制定或通过（法令）
encephalitis	[,ensefə'laitis ]	n.【医】脑炎
enclose	[ in'kləuz ]	v.围绕，包围
encode	[ in'kəud ]	v.译码，编码
encompass	[ in'kʌmpəs ]	v.包含；围绕
encounter	[ in'kauntə ]	v.偶然碰到，遭遇；n.意外相见
encroach	[ in'krəutʃ ]	v.侵犯，侵害
encyclopedia	[ in,saiklə'pi:diə ]	n.百科全书
endanger	[ in'deindʒə ]	v.危及，危害
endeavor	[ in'devə ]	v.努力；事业
endemic	[ en'demik ]	adj.地方性的； n.地方病
endorphin	[ en'dɔ:fin ]	n.【生化】内啡肽（主要存在大脑中，可缓解痛感并影响情绪）
单词	音标	释义
endorse	[ in'dɔ:s ]	v.背书；支持，赞同
endothermic	[ ,endəʊ'θə:mik ]	adj.【动】温血的，恒温的
enforce	[ in'fɔ:s ]	v.实施，执行
engage	[ in'geidʒ ]	v.从事于，忙于
engender	[ in'dʒendə ]	v.产生；引起
engulf	[ in'gʌlf ]	v.吞噬
enhance	[ in'hɑ:ns;  in'hæns ]	v.提高，增加
enlightened	[ in'laitnd ]	adj.开明的，进步的
enlist	[ in'list ]	v.服兵役；征募；谋取（支持、赞助等）
enormous	[ i'nɔ:məs ]	adj.巨大的，极大的
enrich	[ in'ritʃ ]	v.（使）富裕；（使）丰富
enroll	[ in'rəʊl ]	v.入学，招收；加入
ensemble	[ ɔn'sɔmbl ]	n.合唱团（的全体成员）
entail	[ in'teil ]	v.伴随；（使）承担
enterprise	[ 'entəpraiz ]	n.事业；企业
entertainment	[ entə'teinmənt ]	n.娱乐，表演会
enthusiastically	[ in,θju:zi'æstikli ]	adv.热情地，热烈地
entice	[ in'tais ]	v.诱惑，引诱
entitle	[ in'taitl ]	v.命名；（使）有权（拥有或做某事）
entity	[ 'entəti ]	n.实体；统一体
entrant	[ 'entrənt ]	n.进入者；新成员
entrapment	[ in'træpmənt ]	n.诱捕的行动（或过程）
entrepreneur	[ ,ɔntrəprə'nə: ]	n.企业家；承包人
entry	[ 'entri ]	n.进入；入口；登记
enumerate	[ i'nju:məreit; i'nu:məreit ]	v.列举，枚举
envelop	[ in'veləp ]	v.笼罩，包住
envelope	[ 'envələup ]	n.【天】包层
envision	[ en'viʒən ]	v.想象
enzyme	[ 'enzaim ]	n.酵素，酶
epic	[ 'epik ]	n.史诗；叙事诗
epidemic	[ ,epi'demik ]	adj.传染的，流行性的； n.流行病
episode	[ 'episəud ]	n.一段情节；（一个）事件
epochal	[ 'epɔkəl ]	adj.划时代的；有重大意义的
equalize	[ 'i:kwəlaiz ]	v.（使）平衡，相等
equip	[ i'kwip ]	v.装备，配备
equity	[ 'ekwəti ]	n.公平，公正
equivalent	[ i'kwivələnt ]	adj.相同的，相当的；n.等价物
era	[ 'iərə ]	n.纪元，年代；时代
eradicate	[ i'rædikeit ]	v.根除，消灭
erase	[ i'reiz, i'reis ]	v.擦掉，抹去；消除
erode	[ i'rəud ]	v.侵蚀；削弱，损害
errand	[ 'erənd ]	n.差使（事）（如送信，买东西等）
erratic	[ i'rætik ]	adj.反复无常的；古怪的
escalate	[ 'eskəleit ]	v.（使）迅速增加
eschew	[ is'tʃu: ]	v.避开
essence	[ 'esns ]	n.本质；精华
estate	[ i'steit ]	n.财产，地产；遗产
esteem	[ is'ti:m ]	v./n.尊重，尊敬
estimate	[ 'estimeit; 'estimət ]	v./n.估计，评价
et al	[ ,et'æl]	（拉丁文et  alibi的缩写）以及其他人，等人
etched	[ 'etʃid ]	adj.（金属）被（酸）蚀刻的
eternal	[ i'tə:nl ]	adj.永久的，永恒的
ethanol	[ 'eθənəul ]	n.乙醇，酒精
ethic	[ 'eθik ]	n.道德标准，行为准则
ethnic	[ 'eθnik ]	adj.种族的，民族的
ethnographic	[ ,eθnə'græfik ]	adj.人种学的，人种论的
euphoria	[ ju:'fɔ:riə ]	n.精神欢快；兴奋
eusocial	[ ju:'səuʃəl ]	adj.（昆虫）完全群居的
evacuation	[ i,vækju'eiʃn ]	n.撤离，疏散
evade	[ i'veid ]	v.躲开；逃避
evaporate	[ i'væpəreit ]	v.（使）蒸发；消失
eventual	[ i'ventʃuəl ]	adj.最后的，最终的
evident	[ 'evidənt ]	adj.明显的，清楚的
evil	[ 'i:vl ]	n.邪恶；坏事，恶行
evolve	[ i'vɔlv ]	v.（使）进化；（使）逐渐形成
exacerbate	[ ig'zæsəbeit ]	v.加重，恶化
exaggerate	[ ig'zædʒəreit ]	v.夸张，夸大
excavate	[ 'ekskəveit ]	v.挖掘，掘出
exceedingly	[ ik'si:diŋli ]	adv.极端地，非常
exceptional	[ ik'sepʃənl ]	adj.例外的，罕见的；杰出的
excerpt	[ 'eksə:pt ]	n.摘录，选录
excessive	[ ik'sesiv ]	adj.过分的，极度的，过多的
exclude	[ ik'sklu:d ]	v.排斥，排除
exclusively	[ ik'sklu:sivli ]	adv.专有地，排他地
excrete	[ ik'skri:t ]	v.分泌，排泄
excursion	[ ik'skə:ʃn; ik'skə:ʒn ]	n.远足，短途旅行
		
		
单词	音标	释义
execute	[ 'eksikju:t ]	v.执行；制成
exemplary	[ ig'zempləri ]	adj.榜样的，模范的
exemplify	[ ig'zemplifai ]	v.是（或成为）…的典型（或榜样），例示
exempt	[ ig'zempt ]	v.免除，豁免； adj.被免除的
exert	[ ig'zə:t ]	v.发挥、运用（力量等）；施加
exhaust	[ ig'zɔ:st ]	v.用尽；n.（机器排出的）废气
exhaustive	[ ig'zɔ:stiv ]	adj.详尽的，无遗漏的
exile	[ 'eksail ]	v./n.放逐，流放
exodus	[ 'eksədəs ]	n.（大批的）离开，移居
exonerate	[ ig'zɔnəreit ]	v.证明…无罪；（使）免受指控
exotic	[ ig'zɔtik ]	adj.外来的；异乎寻常的
expatriate	[ ,eks'pætriət; ,eks'peitriət ]	v.移居国外； n.移居国外的人
expedient	[ ik'spi:diənt ]	n.权宜之计；对策
expedition	[ ,ekspi'diʃn ]	n.远征队，探险队
expertise	[ ,ekspə:'ti:z ]	n.专门知识（或技能等），专长
expire	[ ik'spaiə ]	v.期满，终止；断气
explicit	[ ik'splisit ]	adj.清楚的；明确的
explode	[ ik'spləud ]	v.（使某物）爆炸，炸开
exploit	[ ik'splɔit ]	v.开发，利用
explore	[ ik'splɔ: ]	v.探索，探究
export	[ ik'spɔ:t; ek'spɔ:t ]	v./n.出口（物），输出（品）
expound	[ ik'spaund ]	v.解释；阐述
expulsion	[ ik'spʌlʃn ]	n.驱逐，开除
extend	[ ik'stend ]	v.延展，延长
exterminate	[ ik'stə:mineit ]	v.消除，消灭
external	[ ik'stə:nl ]	adj.外面的，表面的
extinct	[ ik'stiŋkt ]	adj.灭绝的；（火山等）熄灭的
extinguish	[ ik'stiŋgwiʃ ]	v.消灭；熄灭
extract	[ ik'strækt ]	v.提取，榨取
extracurricular	[ ,eskstrəkə'rikjulə ]	adj.课外的
extraneous	[ ik'streiniəs ]	adj.无关的；外来的
extrapolation	[ ik,stræpə'leiʃn ]	n.推断，推知
extraterrestrial	[ ,ekstrətə'restriəl ]	adj.地球外的
extreme	[ ik'stri:m ]	n.极端（的事物）；adj.极度的，极端的
fabric	[ 'fæbrik ]	n.织物；构造
facial	[ 'feiʃl ]	adj.面孔的；面部的
facilitate	[ fə'siliteit ]	v.（使）容易，促进
faction	[ 'fækʃn ]	n.派系，派别，激进派
factor	[ 'fæktə(r) ]	n.因素；【数】因子
faculty	[ 'fæklti ]	n.全体教员；（大学的）系；才能
faith	[ feiθ ]	n.信任；信仰
fallow	[ 'fæləu ]	adj.休耕的
fatal	[ 'feitl ]	adj.致命的
fatality	[ fə'tæləti ]	n.死亡（事故）
fault	[ fɔ:lt ]	n.过错；【地】断层
feasible	[ 'fi:zəbl ]	adj.可做的，可实行的
fecundity	[ fi'kʌndəti ]	n.多产；繁殖力
federal	[ 'fedərəl ]	adj.联邦（制）的，联邦政府的
feminist	[ 'feminist ]	n.女权主义者
ferrous	[ 'ferəs ]	adj.含铁的
fertility	[ fə'tiləti ]	n.繁殖力；丰产
fertilized	[ 'fə:təlaizd ]	adj.已受精的
fervent	[ 'fə:vənt ]	adj.强烈的，热烈的
fetal	[ 'fi:təl ]	adj.胎儿的
fetch	[ fetʃ ]	v.售得
feudal	[ 'fju:dl ]	adj.封建制度的
fiber	[ 'faibə(r) ]	n.纤维
fickle	[ 'fikl ]	adj.易变的，不坚定的
fierce	[ fiəs ]	adj.残酷的；凶猛的
filament	[ 'filəmənt ]	n.灯丝；纤维
file	[ fail ]	n.文件；档案；v.提出申请
filibuster	[ 'filibʌstə(r) ]	v.阻挠议案通过；妨碍议事
finite	[ 'fainait ]	adj.有限的；【数】有穷的
fiscal	[ 'fiskl ]	adj.国库的，财政的
fivefold	[ 'faivfəuld ]	adj./adv.五倍的（地）
fixture	[ 'fikstʃə(r) ]	n.[常pl.]（房屋等的）装置，配置
fjord	[ fjɔ:d ]	n.峡湾（尤指挪威海岸边的）
flat	[ flæt ]	adj.平滑的；（收费）统一的；固定的
flavor	[ 'fleivə(r) ]	n.风味；香料
fledgling	[ 'fledʒliŋ ]	n.雏鸟；adj.新兴的
flexible	[ 'fleksəbl ]	adj.易弯曲的，灵活的
flippant	[ 'flipənt ]	adj.无礼的；轻率的
flock	[ flɔk ]	n.（鸟、兽等）一群
flourish	[ 'flʌriʃ ]	v.繁荣；活跃
fluctuate	[ 'flʌktʃueit ]	v.（使）涨落，（使）变化
fluctuation	[ ,flʌktʃu'eiʃn ]	n.波动
单词	音标	释义
fluid	[ 'flu:id ]	n.流体； adj.流体的，流动的
fluorescent	[ flɔ:'resnt; fluə'resnt ]	adj.荧光的
focus	[ 'fəukəs ]	v.（使）聚焦，（使）集中；n.震源，震中
fodder	[ 'fɔdə(r) ]	n.草料
folklore	[ 'fəʊklɔ:(r) ]	n.民俗文化；民俗学
follicle	[ 'fɔlikl ]	n.【解】（体内的）小囊
forage	[ 'fɔridʒ; 'fɔ:ridʒ ]	n.饲料，粮草；v.搜寻，翻寻
forecast	[ 'fɔ:kɑ:st; 'fɔ:kæst ]	n./ v.预测，预报
foreclosure	[ fɔ:'kləʊʒə(r) ]	n.取消抵押品赎回权
foresee	[ fɔ:'si: ]	v.预见
foreshadow	[ fɔ:'ʃædəu ]	v.预示
foresight	[ 'fɔ:sait ]	n.远见，深谋远虑
forestall	[ fɔ:'stɔ:l ]	v.预防，阻止
forfeit	[ 'fɔ:fit ]	v.丧失
forge	[ fɔ:dʒ ]	v.锻造；达成，使形成； n.铁匠铺
format	[ 'fɔ:mæt ]	n.格式，版式； v.（使）格式化
formidable	[ 'fɔ:midəbl ]	adj.可怕的；困难的
formula	[ 'fɔ:mjulə ]	n.公式
forthcoming	[ ,fɔ:θ'kʌmiŋ ]	adj.将来的；现成的，随要随到的
fortify	[ 'fɔ:tifai ]	v.增强营养
fossil	[ 'fɔsl ]	n.化石
foster	[ 'fɔstə(r); 'fɔ:stə(r) ]	v.加强，促进
fraction	[ 'frækʃn ]	n.片段；小部分；分数
fracture	[ 'fræktʃə(r) ]	n.骨折；折断
fragile	[ 'frædʒail; 'frædʒl ]	adj.脆的，易碎的；脆弱的
fragment	[ 'frægmənt; fræg'ment ]	n.碎片；部分
frame	[ freim ]	n.框架； v.诬陷
framework	[ 'freimwə:k ]	n.框架
fraternal	[ frə'tə:nl ]	adj.兄弟的
friction	[ 'frikʃn ]	n.摩擦
frontier	[ 'frʌntiə(r) ]	n.国境；边缘地带
frugal	[ 'fru:gl ]	adj.节约的，节俭的
frustrate	[ frʌs'treit; 'frʌstreit ]	v.挫败；（使）沮丧
fuel	[ 'fju:əl ]	n.燃料； v.给…加燃料；刺激，推动
function	[ 'fʌŋkʃn ]	v.运行；起作用； n.职责；作用；官能
fungi	['fʌŋgai ]	n.(fungus的复数)真菌；突然发生并迅速发展的东西
funnel	[ 'fʌnl ]	n.汇集，集中
furnace	[ 'fə:nis ]	n.熔炉
futile	[ 'fju:tail; 'fju:tl ]	adj.无益的；无用的
gadgeteering	[ ,gædʒi'tiəriŋ ]	n.精妙的机器发明（设计）
galaxy	[ 'gæləksi ]	n.银河，星系
garment	[ 'gɑ:mənt ]	n.（一件）衣服，外衣
gauge	[ geidʒ ]	n.标准规格；量具； v.测量；判断
generate	[ 'dʒenəreit ]	v.生成，产生；引起
genetic	[ dʒi'netik ]	adj.基因的，遗传的
genial	[ 'dʒi:niəl ]	adj.亲切的；和蔼的
gentry	[ 'dʒentri ]	n.贵族，绅士，上等人
genuine	[ 'dʒenjuin ]	adj.真正的
geometric	[ dʒiə'metrik ]	adj.几何的；成几何级数增长的
geophysical	[ ,dʒiəʊ'fizikl ]	adj.地球物理学的
gimmick	[ 'gimik ]	n.伎俩，噱头
glacier	[ 'glæsiə ]	n.冰河，冰川
gland	[ glænd ]	n.【解】腺
glean	[ gli:n ]	v.收集，采集
gloomy	[ 'glu:mi ]	adj.悲观的
glucose	[ 'glu:kəus ]	n.葡萄糖
gorilla	[ gə'rilə ]	n.大猩猩
gourmet	[ 'guəmei ]	n.美食家
gradient	[ 'greidiənt ]	n.梯度；【生】生理梯度
grant	[ grɑ:nt ]	v.同意，认可；允许；提供，授予； n.补助
graph	[ grɑ:f;  græf ]	n.图表，坐标图
graphite	[ 'græfait ]	n.石墨
gravitational	[ ,grævi'teiʃənəl ]	adj.重力的，万有引力的
gregarious	[ gri'gɛəriəs ]	adj.群居的
grill	[ gril ]	n.烤架
grind	[ graind ]	v.磨（碎）；伴随摩擦而移动
grove	[ grəuv ]	n.树丛，小果园
guarantee	[ ,gærən'ti: ]	n./v.保证，担保
gut	[ gʌt ]	n.[pl.]内脏；肠子
gyroscope	['dʒairəskəup ]	n.陀螺，回转仪
habitat	[ 'hæbitæt ]	n.栖息地
hail	[ heil ]	v.向…欢呼
hamper	[ 'hæmpə(r) ]	v.阻碍；牵制
handicap	[ 'hændikæp ]	n.障碍；残废；v.（使）不利
hardy	[ 'hɑ:di ]	adj.（植物）抵抗力强的
harmonize	[ 'hɑ:mənaiz ]	v.（使）和谐，（使）协调
单词	音标	释义
harness	[ 'hɑ:nis ]	n.马具；v.利用
hatch	[ hætʃ ]	v.孵出，孵化
haunt	[ hɔ:nt ]	v.常去，常到（某地）
haven	[ 'heivn ]	n.港口；安息所，避难所
havoc	[ 'hævək ]	n.大破坏，浩劫
hazard	[ 'hæzəd ]	n.危险，冒险； v.尝试着做（或提出）
haze	[ heiz ]	n.霾，薄雾
headquarters	[ ,hed'kwɔ:təz ]	n.总部，指挥部
hedge	[ hedʒ ]	v.围困；限制
hedgehog	[ 'hedʒhɔg； (US)-hɔ:g ]	n. 【动】猬；<美>豪猪
heed	[ hi:d ]	v.注意，留心
helicopter	[ 'helikɔptə(r) ]	n.直升飞机
hemoglobin	[ ,hi:məu'gləubin ]	n.【生化】血红蛋白，血色素
herbicide	[ 'hə:bisaid; 'ə:rbisaid ]	n.除草剂
herbivore	[ 'hə:bivɔ:(r); 'ə:rbivɔ:(r) ]	n.【动】食草动物
herd	[ hə:d ]	n.兽群；牧群； v.放牧
hereditary	[ hi'reditəri; hi'rediteri ]	adj.世袭的；遗传的
hexagonal	[ heks'ægənəl ]	adj.六角形的；六边形的
hide	[ haid ]	n.兽皮
hierarchy	[ 'haiərɑ:ki ]	n.等级制度，层次
hieroglyphic	[ ,haiərə'glifik ]	n.象形文字
highlight	[ 'hailait ]	v.（使）突出；集中注意力于
hike	[ haik ]	n.徒步旅行
hinder	[ 'hində(r) ]	v.阻止；妨碍
hint	[ hint ]	n.线索；[常pl.]建议
hinterland	[ 'hintəlænd ]	n.内地；穷乡僻壤
Hispanic	[ hi'spænik ]	adj.西班牙的，说西班牙语的
hitherto	[ ,hiðə'tu: ]	adv.迄今，到目前为止
hoary	[ 'hɔ:ri ]	adj.古老的
homeostasis	[ ,həumiəu'steisis ]	n.体内平衡
homing	[ 'həumiŋ ]	adj.（动物）有回家本能的
hominid	[ 'hɔminid ]	n./adj.原始人类（的）；灵长目动物（的）
homogeneity	[ ,hɔmədʒi'ni:əti ]	n.同种，同质
hone	[ həun ]	v.用磨刀石磨；磨练
hormone	[ 'hɔ:məun ]	n.荷尔蒙；激素
horticultural	[ ,hɔ:ti'kʌltʃərəl ]	adj.园艺的；园艺学的
hospitable	[ hɔ'spitəbl ]	adj.（气候、环境）宜人的
household	[ 'haushəuld ]	n.家庭； adj.普通的；家庭的
hover	[ 'hɔvə(r); 'hʌvər ]	v.（鸟等）盘旋；徘徊
howl	[ haul ]	v./n.（狼、狗等）嗥叫；（风等）呼啸
hue	[ hju: ]	n.颜色，色彩
hum	[ hʌm ]	v.哼，发出嗡嗡声
humane	[ hju:'mein ]	adj.仁慈的
humble	[ 'hʌmbl ]	adj.谦逊的；地位（或身份）低下的
humid	[ 'hju:mid ]	adj.潮湿的，湿润的
hurricane	[ 'hʌrikən; -kein ]	n.飓风
hybrid	[ 'haibrid ]	adj.杂交的，杂种的
hydrogen	[ 'haidrədʒən ]	n.氢
hydroponic	[ ,haidrə'pɔnik ]	adj.溶液培养的，无土栽培的
hypnotize	[ 'hipnətaiz ]	v.对…施催眠术
hypothesize	[ hai'pɔθəsaiz ]	v.假定，假设
iconography	[ ,aikɔ'nɔgrəfi ]	n.肖像；图像
identical	[ ai'dentikl ]	adj.同一的；相同的
identify	[ ai'dentifai ]	v.识别，鉴别
identity	[ ai'dentəti ]	n.身份，特征；同一（性）
ideographic	[ ,idiəu'græfik ]	adj.表意文字（符号）的
ideology	[ ,aidi'ɔlədʒi ]	n.思想体系，意识形态
idiosyncrasy	[ ,idiə'siŋkrəsi ]	n.癖好，特性
idle	[ 'aidl ]	adj.闲置的；无用的
ignite	[ ig'nait ]	v.点燃；着火
illegal	[ i'li:gl ]	adj.违法的，非法的
illicit	[ i'lisit ]	adj.违法的，不正当的
illiterate	[ i'litərit ]	n.文盲
illuminate	[ i'lju:mineit ]	v.照明；说明
illustrate	[ 'iləstreit ]	v.举例说明
imitate	[ 'imiteit ]	v.模仿；仿造
immune	[ i'mju:n ]	adj.免疫的
impact	[ 'impækt ]	n./ v.碰撞；影响
impartial	[ im'pɑ:ʃl ]	adj.不偏不倚的，公正的
impede	[ im'pi:d ]	v.妨碍，阻碍
implausible	[ im'plɔ:zəbl ]	adj.难以置信的
implement	[ 'implimənt ]	v.实施，贯彻； n.[常pl.]工具
implication	[ ,impli'keiʃn ]	n.含义；[常pl.]推断，结论
implicit	[ im'plisit ]	adj.含蓄的；潜在的
imply	[ im'plai ]	v.暗示，暗指
单词	音标	释义
impose	[ im'pəuz ]	v.征（税等），处以（罚款、监禁等），强制实行，强加于
impoverished	[ im'pɔvəriʃt ]	adj.穷困的
impulse	[ 'impʌls ]	n.冲动；脉冲
in lieu of	[ ,in'lju:əv ]	代替
inalienable	[ in'eiljənəbl ]	adj.（指权利等）不可让与的，不可剥夺的
incentive	[ in'sentiv ]	n.刺激；动机
incineration	[ in,sinə'reiʃn ]	n.焚烧
inconsistent	[ ,inkən'sistənt ]	adj.不一致的，矛盾的
incorporate	[ in'kɔ:pəreit ]	v.合并，并入
increment	[ 'inkrəmənt ]	n.增量；增加
incur	[ in'kə:(r) ]	v.招致；遭受，遭遇
incursion	[ in'kə:ʃn ]	n.侵犯，入侵
indenture	[ in'dentʃə ]	n.契约； v.以契约约束
index	[ 'indeks ]	n.索引；指数
indicate	[ 'indikeit ]	v.显示，表明；指出
indicative	[ in'dikətiv ]	adj.标示的，象征的
indifference	[ in'difrəns ]	n.冷漠，不关心
indigenous	[ in'didʒənəs ]	adj.土产的，本地的
indigent	[ 'indidʒənt ]	adj.贫穷的
indiscriminate	[ ,indi'skriminət ]	adj.不加区别的；不受限制的
indispensable	[ ,indi'spensəbl ]	adj.必不可少的
induce	[ in'dju:s; in'du:s ]	v.引诱；促使，引起
indulge	[ in'dʌldʒ ]	v.享受；沉眠于；放纵
inertia	[ i'nə:ʃə ]	n.惰性；惯性
inevitable	[ in'evitəbl ]	adj.不可避免的
inextricably	[ ,in'ekstrikəbli ]	adv.无法分开地
infancy	[ 'infənsi ]	n.婴儿期；初期
infect	[ in'fekt ]	v.感染；使恶化
infer	[ in'fə:(r) ]	v.推论，推断
inferior	[ in'fiəriə(r) ]	adj.次的，较差的
infest	[ in'fest ]	v.大批滋生，蔓延
infirmary	[ in'fə:məri ]	n.医院，医务室
inflammatory	[ in'flæmətri; in'flæmətɔ:ri ]	adj.煽动性的；发炎的
inflate	[ in'fleit ]	v.充气；抬高（物价）；（通货）膨胀
inflict	[ in'flikt ]	v.使…遭受
influx	[ 'inflʌks ]	n.流入，汇集
infrared	[ ,infrə'red ]	adj.红外线的，红外区的
infuse	[ in'fju:z ]	v.灌输
ingenious	[ in'dʒi:njəs ]	adj.聪明的；创新的
ingenuity	[ ,indʒi'nju:əti; ,indʒi'nu:əti ]	n.巧思；独创性
ingest	[ in'dʒest ]	v.咽下，吸收
ingrained	[ in'greind ]	adj.根深蒂固的
ingredient	[ in'gri:diənt ]	n.成分，要素；（烹调的）配料
inhabit	[ in'hæbit ]	v.居住于，栖居于
inhalation	[ ,inhə'leiʃn ]	n.吸入
inherent	[ in'hiərənt ]	adj.固有的，内在的
inherit	[ in'herit ]	v.遗传；继承
inhibit	[ in'hibit ]	v.阻止；抑制
initial	[ i'niʃl ]	adj.最初的，初始的
initiate	[ i'niʃieit ]	v.开始，发起
inlet	[ 'inlet ]	n.<口>进水
innate	[ i'neit ]	adj.天生的，固有的
inoculate	[ i'nɔkjuleit ]	v.接种；给…预防注射
inquisitive	[ in'kwizətiv ]	adj.好奇的
inscribe	[ in'skraib ]	v.刻；【数】使（图形）内接（切）
insecticide	[ in'sektisaid ]	n.杀虫剂
insert	[ in'sə:t ]	v.插入
insight	[ 'insait ]	n.洞察力，见识
insofar as	[ ,insəu'fɑ: (r) æz]	到…程度；在…范围内
insomnia	[ in'sɔmniə ]	n.失眠
inspection	[ in'spekʃn ]	n.检查；视察
install	[ in'stɔ:l ]	v.安装，安置
instantaneous	[ ,instən'teinjəs ]	adj.即时的
instill	[ in'stil ]	v.逐渐灌输
institution	[ ,insti'tju:ʃn; ,insti'tu:ʃn ]	n.（教育、慈善等）社会公共机构
instruct	[ in'strʌkt ]	v.指示；教育，指导
instrument	[ 'instrumənt ]	n.仪器；手段；工具
insulate	[ 'insjuleit; 'insəlet ]	v.使绝缘（尤指热量、电流等）
insulin	[ 'insjulin ]	n.胰岛素
insuperable	[ in'sju:pərəbl ]	adj.难以克服的
intact	[ in'tækt ]	adj.完整的，未动过的
intake	[ 'inteik ]	n.摄取，摄入
intangible	[ in'tændʒəbl ]	adj.无形的，难以确定的
integer	[ 'intidʒə(r) ]	n.整数
integrate	[ 'intigreit ]	v.一体化，成整体
单词	音标	释义
integrated	[ 'intigreitid ]	adj.综合的；完整的
intense	[ in'tens ]	adj.强烈的，剧烈的
intensify	[ in'tensifai ]	v.加强，增强
intent	[ in'tent ]	n.意图，目的； adj.专心的；急切的
interact	[ ,intər'ækt ]	v.相互作用；相互配合
intercept	[ ,intə'sept ]	v.拦截，截取
interdependence	[ ,intədi'pendəns ]	n.互相依赖
interest rate	[ 'intrist reit]	利率
interfere	[ ,intə'fiə(r) ]	v.干涉，妨碍
interior	[ in'tiəriə(r) ]	n./adj.内部（的）
interlude	[ 'intəlu:d ]	n.插入的时期或事件
intermediary	[ ,intə'mi:diəri; 	n.中间人，媒介物
	,intə'mi:dieri ]	
intermediate	[ ,intə'mi:diət ]	adj.中间的，居中的
interpolation	[ in,tə:pə'leiʃn ]	n.插入；【数】内推法
intersect	[ ,intə'sekt ]	v.相交
intersection	[ ,intə'sekʃn ]	n.交叉点；【数】交集
interservice	[ ,intə'sə:vis ]	adj.【军】各军种间的
intersperse	[ ,intə'spə:s ]	v.散布
interstellar	[ ,intə'stelə(r) ]	adj.星际的
interval	[ 'intəvl ]	n.间隔，间距
intervention	[ ,intə'venʃn ]	n.干涉，介入
intestinal	[ in'testinl ]	adj.肠的
intimate	[ 'intimət ]	adj.极为熟知的
intimate	[ 'intimeit ]	v.暗示
intricate	[ 'intrikət ]	adj.复杂的
intrigue	[ in'tri:g ]	v.引起极大兴趣
intrinsic	[ in'trinsik ]	adj.固有的，内在的
intuition	[ ,intju:'iʃn; ,intu'iʃn ]	n.直觉；由直觉获知的信息
invade	[ in'veid ]	v.侵略，侵袭
invariant	[ in'vɛəriənt ]	adj.不变的
inventory	[ 'invəntri; 'invəntɔ:ri ]	n.存货
invertebrate	[ in'və:tibreit ]	n.无脊椎动物
inverted	[ in'vətid ]	adj.反向的，倒转的
invoke	[ in'vəuk ]	v.行使（法权等），实行
irate	[ ai'reit ]	adj.生气的，愤怒的
ironic	[ ai'rɔnik ]	adj.说反话的，讽刺的
irradiation	[ i,reidi'eiʃən ]	n.放射，照射
irreconcilable	[ i'rekən'sailəbl ]	adj.矛盾的，不能协调的
irreversible	[ ,iri'və:səbl ]	adj.不可改变的
irritant	[ 'iritənt ]	n.刺激物
isolate	[ 'aisəleit ]	v.使孤立；隔离
isotope	[ 'aisətəup ]	n.同位素（两个或更多具有相同原子序数却具有不同的质量数的原子中的一个）
jeopardize	[ 'dʒepədaiz ]	v.危及，危害
judicial	[ dʒu:'diʃl ]	adj.司法的；公正的
jumbo	[ 'dʒʌmbəu ]	adj.巨大的
jurisdiction	[ ,dʒuəris'dikʃn ]	n.管辖权；管辖区域
juror	[ 'dʒuərə ]	n.陪审团成员
justify	[ 'dʒʌstifai ]	v.证明…正当或有理
juvenile	[ 'dʒu:vənail ]	adj.青少年的
juxtapose	[ ,dʒʌkstə'pəuz ]	v.并放，并列
kidney	[ 'kidni ]	n.肾脏
kin	[ kin ]	n.<集合词>家属，亲戚
kinetic	[ ki'netik ]	adj.运动的
lactic	[ 'læktik ]	adj.乳的
lag	[ læg ]	v.落后
lame duck	[ 'leim dʌk]	n.任期将满而未能重新当选的官员（或议员等）
landfill	[ 'lændfil ]	n.垃圾堆；垃圾填埋法
landlocked	[ 'lændlɔkt ]	adj.为陆地所包围的
landscape	[ 'lændskeip ]	n.（陆上）风景
lane	[ lein ]	n.行车道
lapse	[ læps ]	n.（时间的）流逝
larva	[ 'lɑ:və ]	n.[pl. larvae]幼虫
latch	[ lætʃ ]	n.门锁
lateral	[ 'lætərəl ]	adj.侧生的，侧（面）的
latitude	[ 'lætitju:d; 'lætitu:d ]	n.纬度；自由
launch	[ lɔ:ntʃ ]	v.发起；推出（产品）；发射
laurel	[ 'lɔrəl ]	n.月桂树；荣誉
laxity	[ 'læksəti ]	v.疏忽，不严格
leach	[ li:tʃ ]	v.过滤
lease	[ li:s ]	n.租约，租期； v.出租，租赁
leaven	[ 'levn ]	v.发酵
leery	[ 'liəri ]	adj.怀疑的，不相信的
legitimate	[ li'dʒitimeit ]	adj.合法的；正当的
lessen	[ 'lesn ]	v.减轻，减少
lethal	[ 'li:θəl ]	adj.致命的；极其有害的
letup	[ 'let,ʌp ]	n.停顿
单词	音标	释义
levy	[ 'levi ]	v./n.征税
liable	[ 'laiəbl ]	adj.易于…的
limestone	[ 'laimstəun ]	n.石灰石
linear	[ 'liniə ]	adj.线的；直线的
lipoprotein	[ ,lipəu'prəuti:n ]	n.脂蛋白（一种复合蛋白质，至少一种成分为油脂）
liquidation	[ ,likwi'deiʃn ]	n.（企业的）清算
listlessness	[ 'listlisnis ]	n.倦怠，无精打采
literacy	[ 'litərəsi ]	n.识字；有文化
literally	[ 'litərəli ]	adv.照字面意思地
litigant	[ 'litigənt ]	n.诉讼人
liver	[ 'livə ]	n.肝脏
lizard	[ 'lizəd ]	n.蜥蜴
loaf	[ ləuf ]	n.块
lobby	[ 'lɔbi ]	n.大厅，休息室； v.向（议员等）进行游说
lobe	[ ləub ]	n.（脑、肺、肝等的）叶
lobster	[ 'lɔbstə ]	n.龙虾
locomotion	[ ,ləukə'məuʃn ]	n.运动（力），移位
lodge	[ lɔdʒ ]	n.房子，住处
logotype	[ 'ləugəutaip ]	n.标志
longevity	[ lɔn'dʒevəti ]	n.长寿
loom	[ lu:m ]	v.隐现
lore	[ lɔ: ]	n.知识；学问
lounge	[ laundʒ ]	n.长沙发
lucrative	[ 'lu:krətiv ]	adj.赚钱的；有利可图的
lumber	[ 'lʌmbə ]	n.木材
lump	[ lʌmp ]	n.块，肿块； v.将…归并到一起
lunar	[ 'lu:nə ]	adj.月球的，有关月球的
lure	[ ljuə ]	v.吸引，诱惑
lymph	[ limf ]	n.淋巴（腺）
lysis	[ 'laisis ]	n.（细胞的）分解
magmatic	[ 'mægmætik ]	adj.岩浆的
magnesium	[ mæg'ni:ziəm ]	n.【化】镁
magnet	[ 'mægnit ]	n.磁铁，磁体
magnitude	[ 'mægnitju:d; 'mægnitu:d ]	n.重要性；长度；震级
mainstream	[ 'meinstri:m ]	n.主流；主要倾向
malaria	[ mə'lɛəriə ]	n.疟疾
maldistribution	[ ,mældistri'bju:ʃn ]	n.（财、物等）分配不当
malfunction	[ mæl'fʌŋkʃn ]	v.失灵，发生故障； n.故障
malleable	[ 'mæliəbl ]	adj.易改变的
malpractice	[ ,mæl'præktis ]	n.治疗失当
mammalian	[ mæ'meiliən ]	adj.哺乳动物的
mandatory	[ 'mændətəri; 'mændətɔ:ri ]	adj.强制的，命令的
maneuver	[ mə'nu:və ]	n./v.操纵，管理
manic	[ 'mænik ]	adj.狂躁的； n.狂躁者
manipulate	[ mə'nipjuleit ]	v.操纵，操作
mannerism	[ 'mænərizəm ]	n.特殊习惯，怪癖
mantle	[ 'mæntl ]	n.覆盖物；地幔（位于地壳和地核之间的地层）
manual	[ 'mænjuəl ]	adj.手工的
manufacture	[ ,mænju'fæktʃə ]	v.生产
manumission	[ ,mænju'miʃn ]	n.解放
manuscript	[ 'mænjuskript ]	n.原稿，手稿
margin	[ 'mɑ:dʒin ]	n.差额；页边的空白；边缘；利润
marital	[ 'mæritl ]	adj.婚姻的；夫妻的
marrow	[ 'mærəu ]	n.骨髓，精华
marshy	[ 'mɑ:ʃi ]	adj.沼泽的，生于沼泽的
martial	[ 'mɑ:ʃl ]	adj.军事的
masculine	[ 'mæskjulin ]	adj.男性的；男子气概的
mass	[ mæs ]	n.【物】质量；大量
mass-transit	[ mæs'trænzit ]	n.公共交通
materialistic	[ mə,tiəriə'listik ]	adj.唯物主义的
maternal	[ mə'tə:nl ]	adj.母亲的；母方的；母系的
matrix	[ 'meitriks ]	n.模型；母体
maturation	[ ,mætʃu'reiʃn ]	n.成熟
mature	[ mə'tjuə; mə'tuə ]	v./adj.成熟（的）
maxim	[ 'mæksim ]	n.格言
measles	[ 'mi:zlz ]	n.（单复数同）麻疹
mechanism	[ 'mekənizəm ]	n.机械装置；机制
median	[ 'mi:diən ]	adj.中间的； n.（三角形）中线；中数（把观测值按大小次序排列后，排在中间位置的数值）
mediate	[ 'mi:dieit ]	v.作为媒介引起
medication	[ ,medi'keiʃn ]	n.药物疗法；药物，药剂
medieval	[ ,medi'i:vl; ,mi:di'i:vl ]	adj.中世纪的，中古的
medium	[ 'mi:diəm ]	adj.中等的； n.[pl. media]媒体
megalithic	[ ,megə'liθik ]	adj.巨石制的
melancholy	[ 'melənkɔli ]	adj.忧郁的
membrane	[ 'membrein ]	n.薄膜，细胞膜
单词	音标	释义
memoir	[ 'memwɑ: ]	n.[常 pl.]回忆录
merchant	[ 'mə:tʃənt ]	n.商人
metabolic	[ ,metə'bɔlik ]	adj.新陈代谢的
metaphor	[ 'metəfə ]	n.隐喻，暗喻
meteor	[ 'mi:tiə ]	n.【天】流星
meteorological	[ ,mi:tiərə'lɔdʒikl; 	adj.气象学的；气象的
	,mi:tiɔ:rə'lɔdʒikl ]	
methane	[ 'mi:θein ]	n.甲烷，沼气
metric	[ 'metrik ]	adj.公制的
microbe	[ 'maikrəub ]	n.微生物；病菌
microorganism	[ ,maikrəu'ɔ:gənizəm ]	n.微生物
microscopic	[ ,maikrə'skɔpik ]	adj.极小的
migraine	[ 'mi:grein; 'maigrein ]	n.周期性偏头痛
mileage	[ 'mailidʒ ]	n.英里数；（耗油1加仑所行使的）英里里程
milieu	[ 'mi:ljə:; ,mi:'ljə: ]	n.环境
militancy	[ 'militənsi ]	n.战斗（性）；战斗精神
millennium	[ mi'leniəm ]	n.[pl. millennia]一千年
mimic	[ 'mimik ]	v.模仿，效仿
miniature	[ 'minətʃə; 'miniətʃuə ]	adj.微型的，小型的； n.缩小的模型
minimum	[ 'miniməm ]	n.最小值； adj.最低的
mint	[ mint ]	v.铸造
minus	[ 'mainəs ]	prep.减去； adj.减的；负的
minute	[ mai'nju:t ]	adj.微小的，极小的
mishap	[ 'mishæp ]	n.不幸，坏运气
misinterpret	[ ,misin'tə:prit ]	v.误解
misrepresent	[ ,misrepri'zent ]	v.歪曲，不如实地叙述（或说明）
missile	[ 'misail; 'misl ]	n.导弹
mitigate	[ 'mitigeit ]	v.减轻
modem	[ 'məudem ]	n.调制解调器
modest	[ 'mɔdist ]	adj.适度的；朴实的
mold	[ məuld ]	n.模子； v.塑造；对…产生影响
mole	[ məul ]	n.鼹鼠
molecule	[ 'mɔlikju:l ]	n.分子
molten	[ 'məultən ]	adj.熔融的，熔化的
monarch	[ 'mɔnək ]	n.君主
monitor	[ 'mɔnitə ]	v.监控
mononucleosis	[ 'mɔnəu,nju:kli:'əusis ]	n.单核细胞增多症
monopoly	[ mə'nɔpəli ]	n.垄断；专利权
monsoon	[ mɔn'su:n ]	n.季风；雨季
mooring	[ 'mɔ:riŋ; 'muəriŋ ]	n.停泊处
morale	[ mə'rɑ:l;  mə'ræl ]	n.士气
morphine	[ 'mɔ:fi:n ]	n.吗啡
mortality	[ mɔ:'tæləti ]	n.死亡率
mortgage	[ 'mɔ:gidʒ ]	n.抵押贷款； v.抵押
mosque	[ mɔsk ]	n.清真寺
mosquito	[ məs'ki:təu ]	n.蚊子
motion	[ 'məuʃn ]	n.运动；提议（尤指会议提案）
mound	[ maund ]	n.土丘，土墩
mount	[ maunt ]	v.增加，增长
mow	[məu ]	v.割（草等）
multicellular	[ ,mʌlti'seljulə ]	adj.多细胞的
multiple	[ 'mʌltipl ]	n.倍数
multiply	[ 'mʌltiplai ]	v.乘；增加
multitude	[ 'mʌltitju:d; 'mʌltitu:d ]	n.大量，众多
municipal	[ mju:'nisipl ]	adj.市的；市政的
mural	[ 'mjuərəl ]	n.壁画
mutation	[ mju:'teiʃn ]	n.突变，变异
mutual	[ 'mju:tʃuəl ]	adj.相互的；共同的
mystic	[ 'mistik ]	adj.神秘的；神秘主义的； n.神秘主义者
mythic	[ 'miθik ]	adj.虚构的；神话（般）的
mythology	[ mi'θɔlədʒi ]	n.神话；神话学
naturalize	[ 'nætʃərəlaiz ]	v.使（外国人）入籍
navy	[ 'neivi ]	n.海军
nebula	[ 'nebjulə ]	n.星云
necessitate	[ ni'sesiteit ]	v.需要，（使）成为必要
needy	[ 'ni:di ]	adj.贫穷的
negative	[ 'negətiv ]	adj.否定的；消极的；负的
negligence	[ 'neglidʒəns ]	n.疏忽，粗心大意
negotiate	[ ni'gəuʃieit ]	v.谈判；（通过谈判或协商）达成协议
nematode	[ 'nemətəud ]	n.线虫类
neural	[ 'njuərəl ]	adj.神经（系统）的
neuron	[ 'njuərɔn ]	n.神经元，神经细胞
neutral	[ 'nju:trəl ]	adj.中间的；中立的
neutron	[ 'nju:trɔn ]	n.中子
newlywed	[ 'nju:liwed ]	n.新婚的人
nexus	[ 'neksəs ]	n.关系
单词	音标	释义
niche	[ nitʃ ]	n.壁龛；【生】生态龛；特定市场
nihilism	[ 'naiilizəm ]	n.虚无主义
nocturnal	[ nɔk'tə:nl ]	adj.夜晚的，夜间活动的
nomad	['nəumæd ]	n.流浪者；游牧部落的人
nominate	[ 'nɔmineit ]	v.提名
nonbiodegradable	[ 'nɔn,baiəudi'greidəbl ]	adj.不能生物降解的
noncommittal	[ ,nɔnkə'mitl ]	adj.不负责的；不明朗的
nonessential	[ ,nɔni'senʃl ]	adj.不重要的；非必需的
nonstarter	[ ,nɔn'stɑ:tə ]	n.毫无成功希望的人
note	[ nəut ]	n.记录；音符；v.注意；指出
notify	[ 'nəutifai ]	v.通知，报告
notorious	[ nəu'tɔ:riəs ]	adj.声名狼藉的
novel	[ 'nɔvl ]	n.（长篇）小说； adj.新颖的，新奇的
novice	[ 'nɔvis ]	n.新手
noxious	[ 'nɔkʃəs ]	adj.有毒的，有害的
nuclear	[ 'nju:kliə ]	adj.核心的；核子的，原子核的
nucleon	[ 'nju:kliɔn ]	n.核子
nucleotide	[ 'nju:kliətaid ]	n.核苷酸
nucleus	[ 'nju:kliəs; 'nu:kliəs ]	n.[pl. nuclei] 核，核心
numerator	[ 'nju:məreitə; 'nu:məreitə]	n.【数】分子
nutrition	[ nju:'triʃn; nu:'triʃn ]	n.营养
oats	[ əuts ]	n.燕麦；燕麦片
obese	[ əu'bi:s ]	adj.肥胖的
objective	[ əb'dʒektiv ]	adj.客观的； n.目标，目的
oblique	[ ə'bli:k ]	adj.斜的，倾斜的
obscure	[ əb'skjuə ]	adj.模糊的； v.使…不明显
observatory	[ əb'zə:vətri; əb'zə:vətɔ:ri]	n.天文台
obsess	[ əb'ses ]	v.（使）困扰，（使）着迷
obsolescence	[ ,ɔbsə'lesns ]	n.过时
obstacle	[ 'ɔbstəkl ]	n.障碍
odd	[ ɔd ]	adj奇怪的；奇数的；n.[pl. odds]可能性；不平等
odometer	[ ɔ'dɔmitə ]	n.（汽车）里程表
odor	[ 'əudə ]	n.气味
off-season	[ 'ɔfsi:zn; 'ɔ:fsi:zn ]	n.淡季；  adj.淡季的
offset	[ 'ɔfset; 'ɔ:fset ]	v.抵销；补偿
offshoot	[ 'ɔfʃu:t; 'ɔ:fʃu:t ]	n.分支
offspring	[ 'ɔfspriŋ; 'ɔ:fspriŋ ]	n.（动物的）崽；后代
olfactory	[ ɔl'fæktəri ]	adj.嗅觉的
omen	[ 'əumən ]	n.征兆，预兆
omission	[ ə'miʃn ]	n.遗漏
ongoing	[ 'ɔngəuiŋ ]	adj.进行中的，不间断的
onset	[ 'ɔnset ]	v.发作，（突然）开始
opaque	[ əu'peik ]	adj.不透明的；难懂的
optical	[ 'ɔptikl ]	adj.眼的，视觉的；光学的
optimal	[ 'ɔptiməl ]	adj.最佳的；n.最大限度
optimism	[ 'ɔptimizəm ]	n.乐观，乐观主义
optimum	[ 'ɔptiməm ]	adj.最好的，最有利的
optometrist	[ ɔp'tɔmitrist ]	n.验光师
ordinance	[ 'ɔ:dinəns ]	n.地方法令
ore	[ ɔ: ]	n.矿，矿砂，矿石
oriented	[ 'ɔ:rientid ]	adj.导向的
originality	[ ə,ridʒə'næləti ]	n.创意，独创性
originate	[ ə'ridʒineit ]	v.出现；开始
ornamentation	[ ,ɔ:nəmen'teiʃn ]	n.装饰物；装饰
orthodox	[ 'ɔ:θədɔks ]	adj.正统的，通常的
osmotic	[ ɔz'mɔtik ]	adj.渗透的，渗透性的
ostentation	[ ,ɔstən'teiʃn ]	n.夸示，炫耀
outcome	[ 'autkʌm ]	n.结果
outfit	[ 'autfit ]	v.配备，装备
outlaw	[ 'autlɔ: ]	v.宣布…为非法
outlay	[ 'autlei ]	n.支出，费用
outlet	[ 'autlet ]	n.出口，通风口；批发商店
outline	[ 'autlain ]	n.轮廓；概述； v.描画轮廓；概括
outlying	[ 'autlaiiŋ ]	adj.远离城市的，边远的
outmoded	[ ,aut'məudid ]	adj.过时了的，不再流行的
outnumber	[ ,aut'nʌmbə ]	v.在数量上超过
outpatient	[ 'autpeiʃnt ]	n.门诊病人
outpost	[ 'autpəust ]	n.前哨（站）
outrage	[ 'autreidʒ ]	v.激怒
outright	[ 'autrait ]	adv.直率地；全部地，彻底地
outstrip	[ ,aut'strip ]	v.超过，胜出
oval	[ 'əuvl ]	adj.卵形的，椭圆形的
overall	[ ,əuvər'ɔ:l ]	adj.全部的；整体上；一般的
overcapitalize	[,əuvə'kæpitəlaiz ]	v.过分投资于
overcharge	[ ,əuvə'tʃɑ:dʒ ]	v.索价过高，收费过高
单词	音标	释义
overflow	[ ,əuvə'fləu ]	v.溢出
overlap	[ ,əuvə'læp ]	n./v.重叠
overlay	[ ,əuvə'lei ]	v.覆盖
overlie	[ ,əuvə'lai ]	v.躺（伏）在…上面
overlook	[ ,əuvə'luk ]	v.忽略，忽视
overlord	[ 'əuvəlɔ:d ]	n.最高领主
overpayment	[,əuvə'peimənt ]	n.多付的款额
overrun	[ ,əuvə'rʌn ]	n.泛滥，超出限度
overstock	[ ,əuvə'stɔk ]	n./v.库存过剩
overt	[ 'əuvə:t ]	adj.公开的，非秘密的
overview	[ 'əuvəvju: ]	n.概观，概述
overwhelm	[ ,əuvə'welm; ,əuvə'hwelm ]	v.淹没；压倒；（使）不知所措
ovulate	[ 'ɔvjuleit ]	v.排卵，产卵
ozone	[ 'əuzəun ]	n.臭氧
pacemaker	[ 'peis,meikə ]	n.领跑者；生物钟
pact	[ pækt ]	n.合同，条约
pad	[ pæd ]	n.便笺本
pagination	[ ,pædʒi'neiʃn ]	n.编页码，标注页码
painstaking	[ 'peinsteikiŋ ]	adj.辛勤的；费力的
palatable	[ 'pælətəbl ]	adj.美味的；受欢迎的
paleoclimatologist	[ ,peiliəu'klaimə'tɔlədʒist ]	n.古气候学家
Paleolithic	[ ,peiliəu'liθik ]	adj.旧石器时代的
pall	[ pɔ:l ]	n.幕，遮盖物
pallid	[ 'pælid ]	adj.苍白的，没血色的；无生气的
palm	[ pɑ:m ]	n.棕榈（树/叶）
paltry	[ 'pɔ:ltri ]	adj.无价值的，微不足道的
pamphlet	[ 'pæmflit ]	n.小册子
panacea	[ ,pænə'siə ]	n.灵丹妙药
panel	[ 'pænl ]	n.专门小组
pang	[ pæŋ ]	n.阵痛；极度悲痛
pant	[ 'pænt ]	n./v.喘，气喘，喘息
pantheon	[ 'pænθiən; 'pænθiɔn ]	n.万神殿；伟人祠
par	[ pɑ: ]	n.同等
paradigm	[ 'pærədaim ]	n.范例，示范
paradox	[ 'pærədɔks ]	n.似非而是的说法；自相矛盾的人（或事物）
parallel	[ 'pærəlel ]	adj.平行的；类似的； n.类似，相似处
paralysis	[ pə'ræləsis ]	n.瘫痪；麻痹
paramount	[ 'pærəmaunt ]	adj.最重要的，决定性的
parasite	[ 'pærəsait ]	n.寄生虫；食客
parish	[ 'pæriʃ ]	n.教区；教区全体居民
parity	[ 'pærəti ]	n.同等，相等
parliament	[ 'pɑ:ləmənt ]	n.国会，议会
parlor	[ 'pɑ:lə ]	n.会客室；店堂；（火车）餐车
parole	[ pə'rəul ]	n.假释
partial	[ 'pɑ:ʃl ]	adj.部分的；偏向的
participatory	[ pɑ:'tisipeitəri]	adj.参与的
particle	[ 'pɑ:tikl ]	n.极少量；微粒
particular	[ pə'tikjulə ]	n.[pl.]详情，细节； adj.特殊的，特别的
particulate	[ pə'tikjulət ]	n.微粒，粒子； adj.微粒的
partisan	[ ,pɑ:ti'zæn ]	adj.有（政治）偏见的
passbook	[ 'pɑ:sbuk ]	n.存折
passive	[ 'pæsiv ]	adj.被动的，消极的
pastoral	[ 'pɑ:stərəl; 'pæstərəl ]	adj.乡村的，农村的
pasture	[ 'pɑ:stʃə; 'pæstʃə ]	n.牧场，牧草
patch	[ pætʃ ]	v.缝补
patent	[ 'peitnt ]	n.专利权（证书）；v.取得…的专利
paternalism	[ pə'tə:nəlizəm ]	n.家长式统治；家长主义
pathogenic	[ pæθə'dʒenik ]	adj.【医】病原的，致病的
patriotic	[ ,pætri'ɔtik; ,peitri'ɔtik ]	adj.爱国的，有爱国心的
patrol	[ pə'trəul ]	v./n.巡逻，巡查
patron	[ 'peitrən ]	n.赞助者；顾客
payroll	[ 'peirəul ]	n.薪金名单；工资总额
peak	[ pi:k ]	n.顶点； adj.最高的； v.到达最高点
peculiar	[ pi'kju:liə ]	adj.独特的，特殊的
pecuniary	[ pi'kju:niəri;  pi'kju:nieri ]	adj.金钱上的，金钱的
peddle	[ 'pedl ]	v.兜售，叫卖
pedestrian	[ pi'destriən ]	n.行人
peel	[ pi:l ]	v.削…的皮； n.（水果等的）皮
peer	[ piə ]	n.同等之人，同辈
pelvis	[ 'pelvis ]	n.骨盆
penalty	[ 'penlti ]	n.处罚；罚款
penetrate	[ 'penitreit ]	v.穿透，渗透
peninsular	[ pə'ninsjulə;  pə'ninsələ ]	n.半岛
pension	[ 'penʃn ]	n.养老金，退休金
per capita	[ pə: 'kæpitə ]	adj.每人，照人数分配的
单词	音标	释义
perceive	[ pə'si:v ]	v.察觉，发觉
perceptibly	[ pə'septəbli ]	adv.可察觉地，可辨地
perennial	[ pə'reniəl ]	adj.长期的； n.多年生植物
perfunctory	[ pə'fʌŋktəri ]	adj.草率的；敷衍的
perimeter	[ pə'rimitə ]	n.周长
periodical	[ ,piəri'ɔdikl ]	adj.周期的，定期的；期刊的； n.期刊
periphery	[ pə'rifəri ]	n.外围
permanent	[ 'pə:mənənt ]	adj.永久的；固定的
permeate	[ 'pə:mieit ]	v.扩散；渗透
permit	[ pə'mit ]	v.允许，许可
permit	[ 'pə:mit ]	n.通行证，许可证
pernicious	[ pə'niʃəs ]	adj.有害的；致命的
perpendicular	[ ,pə:pən'dikjulə ]	adj.垂直的
perpetrator	[ 'pə:pitreitə ]	n.作恶者，犯罪者
perpetuate	[ pə'petʃueit ]	v.延长…的存在，使永记不忘
perplex	[ pə'pleks ]	v.使（某人）困惑；（使）复杂化
persecute	[ 'pə:sikju:t ]	v.迫害
persist	[ pə'sist ]	v.坚持；继续
personnel	[ ,pə:sə'nel ]	n.全体人员；人事部门
perspective	[ pə'spektiv ]	n.（看待事物的）角度，观点
pertinent	[ 'pə:tinənt; 'pə:tənənt ]	adj.相关的
perturb	[ pə'tə:b ]	v.打扰；【天】摄动（引起天体轨道变化）
pervasive	[ pə'veisiv ]	adj.普遍的，流行的
perversion	[ pə'və:ʃn; pə'və:ʒn ]	n.曲解，颠倒
pesticide	[ 'pestisaid ]	n.杀虫剂
petition	[ pə'tiʃn ]	n.请愿；请愿书
petroleum	[ pə'trəuliəm ]	n.石油
pharmacy	[ 'fɑ:məsi ]	n.药房
phase	[ feiz ]	n.阶段
philanthropic	[ ,filən'θrɔpik ]	adj.慈善的，乐善好施的
philosophy	[ fi'lɔsəfi ]	n.哲学；哲理，见解
photon	[ 'fəutɔn ]	n.光子，光量子
photosynthesis	[ ,fəutəu'sinθəsis ]	n.光合作用
physiology	[ ,fizi'ɔlədʒi ]	n.生理学；生理机能
pigment	[ 'pigmənt ]	n.天然色素；干粉颜料
pinpoint	[ 'pinpɔint ]	v.精确定位；准确解释或确定
pirate	[ 'paiərət ]	v.盗版
placate	[ plə'keit; 'pleikeit ]	v.安抚
plague	[ pleig ]	n.瘟疫； v.使苦恼，烦扰
plaintiff	[ 'pleintif ]	n.原告
plateau	[ 'plætəu; plæ'təu ]	n.（上升后的）平台期；v.达到平台期
platform	[ 'plætfɔ:m ]	n.平台
plausible	[ 'plɔ:zəbl ]	adj.似是而非的，貌似有理的
plead	[ pli:d ]	v.作为辩护或理由提出
pledge	[ pledʒ ]	n./v.保证；许诺
plot	[ plɔt ]	n.小块土地； 计划
plow	[ plau ]	n.犁；v.费力穿过
plummet	[ 'plʌmit ]	v.（价格等）骤然下跌
plunge	[ plʌndʒ ]	v.骤降
plywood	[ 'plaiwud ]	n.胶合板
pneumonia	[ nju:'məuniə; nu:'-]	n.肺炎
pneumonic	[ nju:'mɔnik ]	adj.肺的，肺炎的
poacher	[ 'pəutʃə ]	n.偷猎者
polar	[ 'pəulə ]	adj.地极的
poll	[ pəul ]	n.民意测验
pollen	[ 'pɔlən ]	n.花粉
pollinate	[ 'pɔləneit ]	v.授粉，传粉
polygraph	[ 'pɔligrɑ:f ]	n.测谎器
porcelain	[ 'pɔ:səlin ]	n.瓷；瓷器
portfolio	[ pɔ:t'fəuliəu ]	n.投资组合（如债券和股票）
portrait	[ 'pɔ:trit ]	n.肖像；相片
portray	[ pɔ:'trei ]	v.描写，描绘
posit	[ 'pɔzit ]	v.断定，认为
positive	[ 'pɔzətiv ]	adj.肯定的；积极的；【数】正的
possess	[ pə'zes ]	v.具有，拥有
posterity	[ pɔ'sterəti ]	n.子孙，后代
potent	[ 'pəutnt ]	adj.效力强的，烈性的
potter	[ 'pɔtə ]	n.陶工
practitioner	[ præk'tiʃənə ]	n.开业者（医生、律师等）
pragmatic	[ præg'mætik ]	adj.实际的，注重实效的；实用主义的
prairie	[ 'prɛəri ]	n.大草原
单词	音标	释义
precise	[ pri'sais ]	adj.准确的，精确的；严谨的
precursor	[ ,pri:'kə:sə ]	n.先驱；先兆；前身
predate	[ pri:'deit ]	v.居先
predation	[ pri'deiʃn ]	n.捕食（行为、习性等）；掠夺行为
predator	[ 'predətə ]	n.食肉动物
predecessor	[ 'pri:disesə; 'predəsesə ]	n.前任者，（被取代的）人或事物
predicament	[ pri'dikəmənt ]	n.困境，窘境
predicate	[ 'predikeit ]	v.使基于；断言，肯定；暗示
predict	[ pri'dikt ]	v.预言，预测
predisposition	[ ,pri:dispə'ziʃn ]	n.倾向；易患病的体质
predominantly	[ pri'dɔminəntli ]	adv.主要地
predominate	[ pri'dɔmineit ]	v.统治，主导；占优势
preeminent	[ ,pri:'eminənt ]	adj.卓越的，杰出的
preferential	[ ,prefə'renʃl ]	adj.优先的
prefigure	[ ,pri:'figə; ,pri:'figjə ]	v.预示
preflight	[ 'pri:'flait ]	adj.（飞机、人造卫星等）起飞前的
pregnancy	[ 'pregnənsi ]	n.怀孕（期）
prejudice	[ 'predʒudis ]	v./n.偏见，歧视
premature	[ premə'tjuə, pri:mə'tuə ]	adj.过早的
premise	[ 'premis ]	n.前提，假设
premium	[ 'pri:miəm ]	n.保险金
preoccupation	[ ,pri:ɔkju'peiʃn ]	n.先入之见
prepay	[ ,pri:'pei ]	v.预先支付（某费用）
preponderance	[ pri'pɔndərəns ]	n.（压倒性）优势；多数
prerequisite	[ ,pri:'rekwizit ]	n.先决（必备）条件，前提
prescribe	[ pri'skraib ]	v.开（药），开处方
presentation	[ ,prezn'teiʃn; ,pri:zen'teiʃn ]	n.报告；陈述
preserve	[ pri'zə:v ]	v.保持，维持； n.野生动物保护区
preside	[ pri'zaid ]	v.担任主席，主持（会议等）
pressboard	[ 'presbɔ:d ]	n.压制板
prestige	[ pre'sti:ʒ ]	n.威信，声望
presume	[ pri'zju:m; pri'zu:m ]	v.假定，推测
presuppose	[ ,pri:sə'pəuz ]	v.以…为先决条件
pretax	[ 'pri:'tæks ]	adj.（纳）税前的
prevalent	[ 'prevələnt ]	adj.流行的，普遍的
previous	[ 'pri:viəs ]	adj.前面的，在前的
prey	[ prei ]	n.被掠食者；  v.捕食
priest	[ pri:st ]	n.牧师，神父
primary	[ 'praiməri; 'praimeri ]	adj.最初的；基础的；首要的
primate	[ 'praimeit ]	n.灵长类（动物）
primitive	[ 'primitiv ]	adj.原始的；简单的
primordial	[ prai'mɔ:diəl ]	adj.原始的；主要的
princely	[ 'prinsli ]	adj.高贵的；威严的
principal	[ 'prinsəpl ]	adj.主要的； n.校长
priority	[ prai'ɔrəti; prai'ɔ:rəti ]	n.在先；优先权；优先考虑的事
privilege	[ 'privəlidʒ ]	n.特权；优惠
probability	[ ,prɔbə'biləti ]	n.概率；可能性
probe	[ prəub ]	v.探索；n.探测器
procedure	[ prə'si:dʒə ]	n.（议事）程序；步骤
proceed	[ prə'si:d ]	v.继续进行
proceeds	[ 'prəusi:dz ]	n.收益
proclaim	[ prə'kleim ]	v.宣告，声明；显示
procreative	[ 'prəukrieitiv ]	adj.生育的
procure	[ prə'kjuə ]	v.取得，获得
proficient	[ prə'fiʃnt ]	adj.熟练的，精通的
profile	[ 'prəufail ]	n.剖面；轮廓；分布图
profound	[ prə'faund ]	adj.深刻的，意义深远的
prognosis	[ prɔg'nəusis ]	n.预后（对疾病的发作及结果的预言）
progression	[ prə'greʃn ]	n.进展；级数
progressive	[ prə'gresiv ]	adj.上进的；【医】愈来愈严重的
project	[ 'prəudʒekt ]	v.预计
projection	[ prə'dʒekʃn ]	n.预测；规划
prokaryote	[ prəu'kæriəut ]	n.原核生物
proliferate	[ prə'lifəreit; prəu'lifəreit ]	v.激增；繁殖
prominent	[ 'prɔminənt ]	adj.显著的；杰出的
promising	[ 'prɔmisiŋ ]	adj.有希望的；有前途的
prompt	[ prɔmpt ]	v.促使，推动；提示
pronounced	[prə'naunst ]	adj.明显的，显著的
propagandistic	[ ,prɔpəgæn'distik ]	adj.宣传的
propagate	[ 'prɔpəgeit ]	v.繁殖；宣传，使普及
propeller	[ prə'pelə ]	n.螺旋桨，推进器
property	[ 'prɔpəti ]	n.财产，资产；性质
prophet	[ 'prɔfit ]	n.先知，预言家
propitious	[ prə'piʃəs ]	adj.适合的，有利于…的
proponent	[ prə'pəunənt ]	n.拥护者，倡导者
单词	音标	释义
proportion	[ prə'pɔ:ʃn ]	n.比例
proportional	[ prə'pɔ:ʃənl ]	adj.成比例的；均衡的
proprietary	[ prə'praiətri; prə'praiəteri ]	adj.所有的，私人拥有的
prorate	[ prəu'reit ]	v.<美>按比例分配
prose	[ prəuz ]	n.散文
prosecute	[ 'prɔsikju:t ]	v.对…提起公诉
prospect	[ prə'spekt; 'prɔspekt ]	n.前景；期望
prosper	[ 'prɔspə ]	v.兴隆；成功
protege	[ 'prəutəʒei ]	n.（女性为protégée）被保护人；门徒
protein	[ 'prəuti:n ]	n.蛋白质
protestant	[ 'prɔtistənt ]	n.新教（徒）； adj.新教（徒）的
protocol	[ 'prəutəkɔl; 'prəutəkɔ:l ]	n.条约草案，协议
proton	[ 'prəutɔn ]	n.质子
prototype	[ 'prəutətaip ]	n.原型
provenance	[ 'prɔvinəns ]	n.出处，起源
provision	[ prə'viʒn ]	n.供应；（法律等）条款
proviso	[ prə'vaizəu ]	n.限制性条款
provoke	[ prə'vəuk ]	v.产生，引起
proximity	[ prɔk'siməti ]	n.接近
prudent	[ 'pru:dnt ]	adj.谨慎的；深谋远虑的
prudery	[ 'pru:dəri ]	v.过分拘谨，故作正经
pseudonym	[ 'sju:dənim; 'su:dənim ]	n.假名；笔名
psyche	[ 'saiki ]	n.心智；精神
psychopath	[ 'saikəpæθ ]	n.精神变态者
pugnacious	[ pʌg'neiʃəs ]	adj.好斗的
pulp	[ pʌlp ]	n.浆状物；纸浆
pup	[ pʌp ]	n.小狗；幼兽； v.产崽
Puritan	[ 'pjuəritən ]	n.清教徒； adj.清教徒的
purport	[ 'pə:pɔ:t ]	n.意图；vt.声称
pursue	[ pə'sju:; pə'su: ]	v.追求；追击；继续
purview	[ 'pə:vju: ]	n.（工作、活动等的）范围
putty	[ 'pʌti ]	n.油灰；易被摆布的人
pyramid	[ 'pirəmid ]	n.角锥；金字塔
quadrant	[ 'kwɔdrənt ]	n.象限（被坐标轴分开的平面中的四个区域的任一个）
quadruple	[ 'kwɔdrupl; kwɔ'dru:pl ]	v.（使）成四倍
quail	[ kweil ]	n.鹌鹑
qualify	[ 'kwɔlifai ]	v. （使）合格；（使）具有资格
qualitative	[ 'kwɔlitətiv; 'kwɔliteitiv ]	adj.（性）质的，质量的；定性的
quantitative	[ 'kwɔntitətiv; 'kwɔntiteitiv ]	adj.（数）量的，（定）量的，量的
quantum	[ 'kwɔntəm ]	n.[pl. quanta]量；量子
quarantine	[ 'kwɔrənti:n; 'kwɔ:rənti:n ]	n.隔离检疫期
quarry	[ 'kwɔri; 'kwɔ:ri ]	n.猎物
quasar	[ 'kweizɑ: ]	n.【天】类星体
quest	[ kwest ]	v./ n.寻找；寻求
questionnaire	[ ,kwestʃə'nɛə ]	n.问卷，调查表
quiescent	[ kwai'esnt ]	adj.静止的
quiz	[ kwiz ]	n.小测验
quota	[ 'kwəutə ]	n.限额，配额
quote	[ kwəut ]	v.引用，引述
quotient	[ 'kwəuʃnt ]	n.【数】商
raccoon	[ ræ'ku:n ]	n.浣熊
racism	[ 'reisizəm ]	n.种族歧视，种族主义
radiant	[ 'reidiənt ]	adj.容光焕发的
radiate	[ 'reidieit ]	v.放射，辐射
radical	[ 'rædikl ]	adj.激进的； n.激进分子
radioactive	[ ,reidiəu'æktiv ]	adj.放射性的，有辐射能力的
radius	[ 'reidiəs ]	n.半径
raffle	[ 'ræfl ]	n.抽奖
ragtime	[ 'rægtaim ]	n.拉格泰姆音乐（一种早期黑人爵士乐）；滑稽的
raid	[ reid ]	n./ v.劫掠；突袭
rally	[ 'ræli ]	v.（行情、价格等）跌后复升，反弹
ranch	[ ræntʃ ]	n.大农场
rangeland	[ 'reindʒlænd ]	n.牧场
ransom	[ 'rænsəm ]	n.赎金；v.赎出，释放
rating	[ 'reitiŋ ]	n.等级；定额
ratio	[ 'reiʃiəu ]	n.比例
ration	[ 'ræʃən ]	v.定量配给（食物等）
rationale	[ ,ræʃə'nɑ:l; ,ræʃə'næl ]	n.根本性的依据
reactor	[ ri'æktə ]	n.【原】反应堆
readily	[ 'redili ]	adv.乐意地；容易地
realm	[ relm ]	n.领域；国度
rear	[ riə ]	v.抚养； adj.后面的
rebut	[ ri'bʌt ]	v.反驳
recall	[ ri'kɔ:l ]	v.回忆；n.收回
receipt	[ ri'si:t ]	n.收据；[pl.]收入
单词	音标	释义
reception	[ ri'sepʃn ]	n.（无线电、电视等）接收效果
receptive	[ ri'septiv ]	adj.（愿意）接受的
receptor	[ ri'septə ]	n.感（接）受器，受体
recession 	[ ri'seʃn ]	n.衰退，萧条（时期）
recipe	[ 'resəpi ]	n.食谱
recipient	[ ri'sipiənt ]	n.接受者； adj.（愿意）接受的
reciprocal	[ ri'siprəkl ]	adj.相互的；相应的； n. 倒数，互相起作用的事物
reclaim	[ ri'kleim ]	v.收回；恢复（土地）
recommend	[ ,rekə'mend ]	v.推荐；建议
reconcile	[ 'rekənsail ]	v.调停，调解；调和，使一致；使协调，使和解
reconvene	[ ,rikən'vi:n ]	v.再集会
recoup	[ ri'ku:p ]	v.补偿
recourse	[ ri'kɔ:s ]	v.求助；依靠
recreation	[ ,rekri'eiʃən ]	n.娱乐活动，消遣
recruit	[ ri'kru:t ]	n.新成员； v.招收
rectangle	[ 'rektæŋgl ]	n.长方形，矩形
recur	[ ri'kə: ]	v.再发生；重新提起
redress	[ ri'dres ]	n./v.改正；调整
reef	[ ri:f ]	n.礁，暗礁
referendum	[ ,refə'rendəm ]	n.[pl. referenda]公民投票
referral	[ ri'fə:rəl ]	n.推荐
refine	[ ri'fain ]	v.精炼；改善
reflex	[ 'ri:fleks ]	v.（对刺激的本能）反应；[~es]反应能力
refrain	[ ri'frein ]	v.抑制，避免
refugee	[ refju'dʒi:; 'refjudʒi: ]	n.难民
refund	[ ri:'fʌnd ]	n.退款
refutation	[ ,refju:'teiʃn ]	n.反驳，驳斥
refute	[ ri'fju:t ]	v.反驳，驳倒
regenerate	[ ri'dʒenəreit ]	v.（使）再生，（使）恢复
regime	[ rei'ʒi:m ]	n.（气象等的）形态
regiment	[ 'redʒimənt ]	n.军团
regionalization	[ ,ri:dʒənəlai'zeiʃn ]	v.分成地区；按地区安排
regressive	[ ri'gresiv ]	adj.（税率）递减的
reign	[ rein ]	n.统治（时期）
reimburse	[ ,ri:im'bə:s ]	v.偿还
reinforce	[ ,ri:in'fɔ:s ]	v.加强；补充
rekindle	[ ,ri:'kindl ]	v.重新激起
relativity	[ ,relə'tivəti ]	n.相对论
relay	[ ri:'lei ]	v.中继转发，转播
release	[ ri'li:s ]	v./n.排放；发表（布）；解放，释放
relentless	[ ri'lentlis ]	adj.无情的；不断的
reliable	[ ri'laiəbl ]	adj.可靠的，可信赖的
relic	[ 'relik ]	n.文物
relieve	[ ri'li:v ]	v.缓解；减轻
religious	[ ri'lidʒəs ]	adj.宗教的；虔诚的
relinquish	[ ri'liŋkwiʃ ]	v.放弃；交出
reluctant	[ ri'lʌktənt ]	adj.不情愿的，勉强的
remainder	[ ri'meində ]	n.【数】余数；剩余部分
remedy	[ 'remədi ]	n.药（物）；v.补救；纠正
remnant	[ 'remnənt ]	n.残余物，残迹
renaissance	[ 'renəsɔns ]	n.复兴，复活；文艺复兴
renal	[ 'ri:nl ]	adj.肾脏的，肾的
render	[ 'rendə ]	v.溶解；提供；使得
renegade	[ 'renigeid ]	adj.背弃的，离经叛道的
renounce	[ ri'nauns ]	v.声明放弃；拒绝承认
renovation	[ ,renə'veiʃən ]	n.整修；革新
renown	[ ri'naun ]	n.名望，声誉
repeal	[ ri'pi:l ]	v.【律】废除，撤销
repertory	[ 'repətriɔi; 'repətəri ]	n.剧目，作品
replete	[ ri'pli:t ]	adj.充满的
replicate	[ 'replikeit ]	v.复制，重复
representative	[ ,repri'zentətiv ]	n.代表； adj.有代表性的，典型的
reptile	[ 'reptail; 'reptl ]	n.爬行动物
repudiate	[ ri'pju:dieit ]	v.拒绝；拒付
rescind	[ ri'sind ]	v.废除（法律等）
resemble	[ ri'zembl ]	v.类似于，像
resent	[ ri'zent ]	v.怨恨，恼火
reserve	[ ri'zə:v ]	n.储备；v.保留；储备
reservoir	[ 'rezəvwɑ: ]	n.水库；蓄水池
reside	[ ri'zaid ]	v.居住；存在
residue	[ 'rezidju:; 'rezidu: ]	n.剩余物；残余
resign	[ ri'zain ]	v.辞职
resist	[ ri'zist ]	v.抵制，抵抗；抗，耐
resolve	[ ri'zɔlv ]	v.解决；分解；决心
resonance	[ 'rezənəns ]	n.共振
单词	音标	释义
resort	[ ri'zɔ:t ]	v.求助； n.度假胜地
respective	[ ris'pektiv ]	adj.分别的，各自的
respire	[ ris'paiə ]	v.呼吸
resplendent	[ ri'splendənt ]	adj.灿烂的；辉煌的
responsible	[ ri'spɔnsəbl ]	adj.承担责任的；作为原因的
responsive	[ ri'spɔnsiv ]	adj.有反应的；反应迅速的，敏感的
restitution	[ ,resti'tju:ʃn; ,resti'tu:ʃn ]	n.归还；赔偿
restore	[ ri'stɔ: ]	v.恢复；重建
restrain	[ ri'strein ]	v.抑制；限制；阻止
resume	[ ri'zju:m; ri'zu:m ]	v.（中断后）重新开始，继续
resurgence	[ ri'sə:dʒəns ]	n.复苏，复兴
retail	[ 'ri:teil ]	adj.零售的； v.零售
retain	[ ri'tein ]	v.保留，保持；保存，留住
retaliation	[ ri,tæli'eiʃn ]	n.报复
retention	[ ri'tenʃn ]	n.保持，留住
reticent	[ 'retisnt ]	adj.缄默的
retrieve	[ ri'tri:v ]	v.取回；恢复；检索
revamp	[ ,ri:'væmp ]	v.改造；修订，修改
revenue	[ 'revənju:; 'revənu: ]	n.收入；税收
reverence	[ 'revərəns ]	n.尊敬，崇敬
reverse	[ ri'və:s ]	v.取消；逆转； adj.相反的
revert	[ ri'və:t ]	v.恢复原状
revise	[ ri'vaiz ]	v.修订；修改
revitalize	[ ,ri:'vaitəlaiz ]	v.（使）新生，（使）得到复兴
revive	[ ri'vaiv ]	v. （使）复苏；（使）恢复
revolution	[ ,revə'lu:ʃn ]	n.革命；旋转
rewind	[ ri:'waind ]	v.重绕；倒带
rhetoric	[ 'retərik ]	n.雄辩，辩才
rheumatic	[ ru:'mætik ]	adj.风湿病引起的
rhinoceros	[ rai'nɔsərəs ]	n.（缩写rhino）犀牛
rib	[ rib ]	n.肋骨；【船】肋材
ridge	[ ridʒ ]	n.山脊，岭
ridicule	[ 'ridikju:l ]	n./v.嘲笑，嘲弄
rigid	[ 'ridʒid ]	adj.严格的；死板的
rigor	[ 'rigə ]	n.（气候，条件等）严酷；严格；严密
rim	[ rim ]	n.边；轮辋
rinse	[ rins ]	v.冲洗
ripple	[ 'ripl ]	v. （使）起波纹；传开； n.波纹
ritual	[ 'ritʃuəl ]	n.（宗教的）仪式； adj.仪式的
rival	[ 'raivl ]	n.竞争者，可与匹敌的人（物）； adj.竞争的；v.比得上
rodent	[ 'rəudnt ]	n.啮齿类动物
roost	[ ru:st ]	v.栖息
rotate	[ rəu'teit; 'rəuteit ]	v.旋转；轮作
roughly	[ 'rʌfli ]	adv.大概，粗暴地
round	[ raund ]	v.四舍五入；完成
rudder	[ 'rʌdə ]	n.船舵
rudimentary	[ ,ru:di'mentəri ]	adj.基础的，初步的；发育不全的
rug	[ rʌg ]	n.（小）地毯；毛毯
rugby	[ 'rʌgbi ]	n.橄榄球
rugged	[ 'rʌgid ]	adj.高低不平的，崎岖的
ruin	[ 'ru:in ]	v. （使）毁灭；（使）破产
rumor	[ 'ru:mə ]	n.传闻，谣言
runner	[ 'rʌnə ]	n.蔓藤；推销员；长跑者
rupture	[ 'rʌptʃə ]	n.破裂，断裂
sacralization	[ ,seikrəlai'zeiʃn,	n.神化
	 ,sækrəlai'zeiʃən ]	
sacred	[ 'seikrid ]	adj.神圣的
sacrifice	[ 'sækrifais ]	n.牺牲；放弃；v.牺牲
saleable	[ 'seiləbl ]	adj.可出售的，卖得出的
salient	[ 'seiliənt ]	adj.显著的，突出的
saline	[ 'seilain; 'seili:n ]	adj.含盐的，咸的
salvage	[ 'sælvidʒ ]	v.抢救； n.抢救出的财物
sample	[ 'sɑ:mpl; 'sæmpl ]	n.样品；标本； v.取样
samurai	[ 'sæmurai ]	n.武士；[pl.]武士阶层
sanction	[ 'sæŋkʃn ]	n. /v.批准；制裁
sanctuary	[ 'sæŋktʃuəri; 'sæŋktʃueri ]	n.圣堂；避难所；鸟兽禁猎区
sandbar	[ 'sændbɑ: ]	n.沙洲
sane	[ sein ]	adj.健全的；明智的
sanitary	[ 'sænitəri; 'sæniteri ]	adj.卫生的；公共卫生的
saturated	[ 'sætʃəreitid ]	adj.饱和的；浸透的
scale	[ skeil ]	n.鳞片；规模；等级
scapegoat	[ 'skeipgəut ]	n.替罪羊
scarce	[ skɛəs ]	adj.缺乏的；稀有的
scatter	[ 'skætə ]	v.分散，散开
scent	[ sent ]	n.气味；香味
scheme	[ ski:m ]	n.方案
scorn	[ skɔ:n ]	v./n.轻蔑；嘲笑
scorpion	[ 'skɔ:piən ]	n.蝎子
单词	音标	释义
scour	[ 'skauə ]	v.四处搜索
scout	[ skaut ]	n.侦查员（或机、舰）； v.侦查；寻找
scramble	[ 'skræmbl ]	v.攀登；争夺
scrap	[ skræp ]	n.碎屑，废物； v.扔弃； adj.零碎的
scrape	[ skreip ]	v./ n.刮擦；擦伤
screen	[ skri:n ]	n.屏幕； v.筛选；检查
scribe	[ skraib ]	n.抄写员
scrubber	[ 'skrʌbə ]	n.刷子；净气器
scrupulous	[ 'skru:pjuləs ]	adj.谨慎的；严格认真的
scrutinize	[ 'skru:tinaiz; 'skru:tənaiz ]	v.仔细观察，审视
sculpture	[ 'skʌlptʃə ]	n.雕塑品；雕塑（术）；v.雕刻
scurrilous	[ 'skʌrələs ]	adj.粗俗的；诽谤的
secluded	[ si'klu:did ]	adj.偏僻的；隐退的
secrete	[ si'kri:t ]	v.【生】分泌
secure	[ si'kjuə ]	v.获得
sedentary	[ 'sedntri; 'sednteri ]	adj.久坐的；需长坐的
sediment	[ 'sedimənt ]	n.【地】沉淀物
seedling	[ 'si:dliŋ ]	n.幼苗；树苗
seesaw	[ 'si:sɔ: ]	n.跷跷板
segment	[ 'segmənt ]	n.线段；部分，环节
segregate	[ 'segrigeit ]	v.隔离；分开
seismic	[ 'saizmik ]	adj.地震的，有关地震的
semicircle	[ 'semi,sə:kl ]	n.半圆；半圆形体
seminal	[ 'seminl ]	adj.开创性的；重要的
seminar	[ 'seminɑ: ]	n.研讨会
senate	[ 'senit ]	n.[S~]参议院，上议院
sensation	[ sen'seiʃn ]	n.感觉；引起轰动的人或事
sensible	[ 'sensəbl ]	adj.明智的
sensitive	[ 'sensətiv ]	adj.敏感的；易波动的
sensitize	[ 'sensitaiz ]	v.（使某人或某事物）敏感
sentient	[ 'senʃnt ]	adj.有感觉的，有知觉的
sentinel	[ 'sentinl ]	n.哨兵
separate	[ 'sepərət ]	adj.分开的；单个的；不同的
separate	[ 'sepəreit ]	v.分开；分类
sequence	[ 'si:kwəns ]	n.顺序；序列
session	[ 'seʃn ]	n.会议；集会
severe	[ si'viə ]	adj.严重的；严厉的；严酷的
sewage	[ 'su:idʒ ]	n.污物，污水
shareholder	[ 'ʃɛə,həuldə ]	n.股票持有人；股东
shatter	[ 'ʃætə ]	v.粉碎，砸碎；破坏
shed	[ ʃed ]	v.脱落（即蜕皮）；流出，散发
sheer	[ ʃiə ]	adj.薄的；纯粹的
shelter	[ 'ʃeltə ]	n.躲避处； v.庇护，保护
shield	[ ʃi:ld ]	n.盾，保护物； v.保护；挡开
shortfall	[ 'ʃɔ:tfɔ:l ]	v.亏空；不足
shrill	[ ʃril ]	adj.（批评）尖锐的；刺耳的
shrink	[ ʃriŋk ]	v.（使）收缩；减小
shroud	[ ʃraud ]	n.裹尸布；覆盖物
shrub	[ ʃrʌb ]	n.灌木（丛）
shuttle	[ 'ʃʌtl ]	n.航天飞机；穿梭运输工具
sibling	[ 'sibliŋ ]	n.兄弟或姊妹
sidestep	[ 'saidstep ]	v.横跨一步躲避；回避
siege	[ si:dʒ ]	n.包围，围攻
signify	[ 'signifai ]	v.表示，意味着
simulate	[ 'simjuleit ]	v.模仿，假装
simultaneous	[ ,siml'teiniəs;	adj.同时的，同步的
	 ,saiml'teiniəs ]	
sinew	[ 'sinju: ]	n.腱；肌肉
single entry	[ siŋgl'entri ]	adj.单式的；单式记录的
singularly	[ 'siŋgjuləli ]	adv.异常地；特别地
sinus	[ 'sainəs ]	n.穴；【解】窦（主要容纳静脉血的膨胀的通道或空腔）
sip	[ sip ]	v.啜饮，呷
skeleton 	[ 'skelitn ]	n.骨架，骨骼
skeptic	[ 'skeptik ]	n.怀疑者
skeptical	[ 'skeptikl ]	adj.怀疑的
sketch	[ sketʃ ]	n.草图，素描； v.画速写
skull	[ skʌl ]	n.头骨
slam	[ slæm ]	v.猛烈撞击；砰地关上
slice	[ slais ]	n.薄片，切片；部分
slick	[ slik ]	adj.光滑的；聪明的
slight	[ slait ]	adj.少量的；微不足道的
slip	[ slip ]	n.纸片；差错； v.滑行；下降
slope	[ sləup ]	n.斜坡；【数】斜率
slot	[ slɔt ]	n.狭缝；空位
sloth	[ sləuθ ]	n.树獭；懒惰
sluggish	[ 'slʌgiʃ ]	adj.缓慢的
slump	[ slʌmp ]	v./n.下降，暴跌
smear	[ smiə ]	v.涂抹；弄脏
单词	音标	释义
smog	[ smɔg ]	n.烟雾
smokestack	[ 'sməukstæk ]	n.烟囱
smuggler	[ 'smʌglə ]	n.走私者
snap	[ snæp ]	n.摁扣
sniper	[ 'snaipə ]	n.狙击手
snout	[ snaut ]	n.（猪、象等的）口鼻部
snuff	[ snʌf ]	v.（用鼻子）吸； n.鼻烟
soar	[ sɔ: ]	v.高飞；猛增，剧增
sodium	[ 'səudiəm ]	n.【化】钠
solar	[ 'səulə ]	adj.太阳的；（利用）太阳能的
solidarity	[ ,sɔli'dærəti ]	n.团结，一致
solitary	[ 'sɔlitəri; 'sɔliteri ]	adj.单独的；【动】独居的
solvency	[ 'sɔlvənsi ]	n.溶解力；偿付能力
sophisticated	[ sə'fistikeitid ]	adj.老练的，精通的；（仪器）复杂的
sovereign	[ 'sɔvrin ]	n.君主；元首
span	[ spæn ]	n.全长；一段时间
sparse	[ spɑ:s ]	adj.稀少的，贫乏的
spate	[ speit ]	n.大批，大量
spatial	[ 'speiʃəl ]	adj.空间的
spawn	[ spɔ:n ]	n.卵； v.大量产生；引起
specialize	[ 'speʃəlaiz ]	v.专门从事
species	[ 'spi:ʃi:z ]	n.物种
specific	[ spi'sifik ]	adj.具体的；详细而精确的；特殊的
specify	[ 'spesifai ]	v.详细说明
specimen	[ 'spesimən ]	n.样品；标本
specious	[ 'spi:ʃəs ]	adj.华而不实的；似是而非的
spectacular	[ spek'tækjulə ]	adj.壮观的，壮丽的
spectator	[ spek'teitə; 'spekteitə ]	n.观众；旁观者
specter	[ 'spektə ]	n.幽灵；萦绕在心头的恐惧
spectrum	[ 'spektrəm ]	n.范围；光谱；频谱
speculate	[ 'spekjuleit ]	v.推测；做投机买卖
sphere	[ sfiə ]	n.球；领域
spiced	[ 'spaist ]	adj.加香料的，加调料的
spin	[ spin ]	v./n.快速旋转
spine	[ spain ]	n.脊柱；（动植物身上的）刺
spiral	[ 'spaiərəl ]	adj.螺旋形的； v.盘旋上升（或下降）； n.螺旋
spiteful	[ 'spaitfl ]	adj.怀恨的，恶意的
splinter	[ 'splintə ]	n.碎片
splotchy	[ 'splɔtʃi ]	adj.有污点的，污渍斑斑的
sponsor	[ 'spɔnsə ]	v.赞助； n.赞助人
sporadically	[ spə'rædikəli ]	adv.偶发地；零星地
spouse	[ spauz; spaus ]	n.配偶，夫妻
spray	[ sprei ]	n.喷雾（剂），小花枝；v.喷洒
spring	[ spriŋ ]	n.泉；v.跳；出现
sprinkler	[ 'spriŋklə ]	n.洒水装置；消防喷嘴
spruce	[ spru:s ]	n.云杉
spur	[ spə: ]	v.促进，激励；n.刺激
squash	[ skwɔʃ ]	n.南瓜； v.压扁
staggering	[ 'stægəriŋ ]	adj.令人惊愕的
stake	[ steik ]	n.火刑柱；股份
stamina	[ 'stæminə ]	n.耐力；持久力
stance	[ stæns ]	n.态度，立场
staple	[ 'steipl ]	n.主要产品，主要成分；adj.主要的
startlingly	[ 'stɑ:tliŋli ]	adv.令人吃惊地，惊人地
static	[ 'stætik ]	adj.不变的；停滞的
stationary	[ 'steiʃənri; 'steiʃəneri ]	adj.静止的
statistic	[ stə'tistik ]	n.统计；统计资料（数值）
stature	[ 'stætʃə ]	n.身高
status	[ 'steitəs ]	n.身份；地位；状况
statusquoante	[ 'steitəs'kwəu'ænti ]	<拉>原状
statute	[ 'stætju:t ]	n.【律】法令，条例
stave	[ steiv ]	n.狭板，木柱
steep	[ sti:p ]	adj.极高的；v.沉浸；充满
steer	[ stiə ]	n.肉用公牛
stem	[ stem ]	n.茎，干；v.起源于；阻断
steppe	[ step ]	n.（尤指东南欧或西伯利亚地区）无树木的大草原
stereotype	['steriəutaip; 'stiəriəutaip ]	n.铅版；陈规；v.使…一成不变
sterile	[ 'sterail; 'sterəl ]	adj.不育的；贫瘠的；无效果的
stew	[ stju: ]	n.炖菜（肉）；v.炖
stimulant	[ 'stimjulənt ]	n.刺激物；兴奋剂
sting	[ stiŋ ]	v.蛰，叮；n.螫伤
stipend	[ 'staipend ]	n.薪水；定期津贴
stipulate	[ 'stipjuleit ]	v.规定；确定
stitch	[ stitʃ ]	n.缝针；针脚
stock	[ stɔk ]	n.股票；库存； v.储备
storefront	[ 'stɔ:frʌnt]	n.沿街铺面，店堂
单词	音标	释义
strain	[ strein ]	n.血统；【生】品种
strait	[ streit ]	n.海峡
strand	[ strænd ]	n.（线等的）股，缕
strategy	[ 'strætədʒi ]	n.战略；策略
stratosphere	[ 'strætəsfiə ]	n.平流层，同温层（位于对流层之上中顶层之下的范围的大气）
strenuous	[ 'strenjuəs ]	adj.费力的
strife	[ straif ]	n.纷争，冲突
string	[ striŋ ]	v.用线串； n.弦；一串
stringent	[ 'strindʒənt ]	adj.严格的，严厉的
strive	[ straiv ]	v.努力，奋斗
stroke	[ strəuk ]	n.中风；击，敲（钟）；一下完成的动作
stroll	[ strəul ]	v./n.闲逛，散步
strut	[ strʌt ]	n.支柱，支撑
studious	[ 'stju:diəs; 'stu:diəs ]	adj.慎重的；有意的
stumble	[ 'stʌmbl ]	v./n.绊倒
stun	[ stʌn ]	v.（使）昏厥；（使）震惊
stunt	[ stʌnt ]	v.阻碍，妨碍（发育）
sturdy	[ 'stə:di ]	adj.结实的；坚固的
subject	[ 'sʌbdʒekt ]	v.受制于； n.国民
submarine	[ ,sʌbmə'ri:n; 'sʌbməri:n ]	n.潜艇
submit	[ səb'mit ]	v.提交；屈从
subordinate	[ sə'bɔ:dinət; sə'bɔ:dənət ]	adj.下级的； n.下级
subscribe	[ səb'skraib ]	v.订阅
subsequent	[ 'sʌbsikwənt ]	adj.随后的，接续的
subsidiary	[ səb'sidjəri ]	n.子公司
subsidize	[ 'sʌbsidaiz ]	v.补助，资助
subsidy	[ 'sʌbsidi ]	n.津贴，补助
subsistence	[ səb'sistəns ]	n.生存，生计
substance	[ 'sʌbstəns ]	n.实质；物质
substantial	[ səb'stænʃl ]	adj.实际的；大量的
substantiate	[ səb'stænʃieit ]	v.证实，证明
substitute	[ 'sʌbstitju:t; 'sʌbstitu:t ]	n.代替品； v.代替，替代
substrate	[ 'sʌbstreit ]	n.底土层，底土
subtle	[ 'sʌtl ]	adj.细微的
subtract	[ səb'trækt ]	v.减，减去
succession	[ sək'seʃn ]	n.连续；【生】自然演替
sue	[ sju:; su: ]	v.向…起诉，提起诉讼
summit	[ 'sʌmit ]	n.峰顶；最高级会议
superb	[ sju:'pə:b; su:'pə:b ]	adj.上乘的，极好的
superficial	[ sju:pə'fiʃl; su:pə'fiʃl ]	adj.肤浅的；粗略的
superior	[ sju:'piəriə; su:'piəriə ]	adj.较好的； n.上级，长官
supernova	[ ,sju:pə'nəuvə ]	n.【天】超新星
supersede	[ ,sju:pə'si:d; ,su:pə'si:d ]	v.替代，取代
supplement	[ 'sʌplimənt ]	v.补充，增补； n.补充（物），增补（物）
suppress	[ sə'pres ]	v.镇压；抑制，阻止
supreme	[ sju:'pri:m; su:'pri:m ]	adj.最高的；极度的
surcharge	['sə:tʃɑ:dʒ ]	n.附加税；额外费
surge	[ sə:dʒ ]	v./n.汹涌；猛增
surgeon	[ 'sə:dʒən ]	n.外科医师
surpass	[ sə'pɑ:s; sə'pæs ]	v.超越；胜过
surplus	[ 'sə:pləs ]	n.过剩，剩余（物）； adj.剩余的
survey	[ sə'vei; 'sə:vei ]	v./n.调查；视察
susceptible	[ sə'septəbl ]	adj.易受影响的；敏感的
suspect	[ səs'pekt; 'sʌspekt ]	v.怀疑；推测；n.嫌疑犯
suspicion	[ sə'spiʃn ]	n.怀疑，猜疑
sustain	[ sə'stein ]	v.支持，维持；遭受
sustenance	[ 'sʌstinəns ]	n.食物，养料
swiftly	[ 'swiftli ]	adv.很快地，即刻
symbiotic	[ ,simbai'ɔtik ]	adj.共生的，共栖的
sympathetic	[ ,simpə'θetik ]	adj.同情的；赞同的
symptom	[ 'simptəm ]	n.征兆；（病）症状
synthesis	[ 'sinθəsis ]	n.综合；合成
taboo	[ tə'bu:; tæ'bu: ]	adj.讳忌的； n.禁忌；禁止
tactic	[ 'tæktik ]	n.策略；战术
tactile	[ 'tæktail; 'tæktil ]	adj.触觉的
takeover	[ 'teik,əuvə ]	n.接管；收购
tangible	[ 'tændʒəbl ]	adj.可触摸的；切实的
tariff	[ 'tærif ]	n.关税；税率
teem	[ ti:m ]	v.充满，到处都是
temblor	[ tem'blɔ: ]	n.<美>地震
temperance	[ 'tempərəns ]	n.节欲；禁酒
temperate	[ 'tempərət ]	adj.（气候）温和的；有节制的
temporary	[ 'temprəri; 'tempəreri ]	adj.短暂的，暂时的；临时的
tempt	[ tempt ]	v.引诱，吸引
tenant	[ 'tenənt ]	n.房客；佃户
单词	音标	释义
tenet	[ 'tenit ]	n.信条，原则
tentative	[ 'tentətiv ]	adj.试验（性）的，试探（性）的；犹豫的
tenure	[ 'tenjuə(r); 'tenjər ]	n.任期；（土地）保有权
terminate	[ 'tə:mineit ]	v.（使）停止，终止；解雇
terminology	[ ,tə:mi'nɔlədʒi ]	n.术语（学）
termite	[ 'tə:mait ]	n.【昆】白蚁
terrain	[ tə'rein ]	n.地势，地形
territory	[ 'terətri, terətɔ:ri ]	n.地区；领土
testify	[ 'testifai ]	v.作证；证明
testimony	[ 'testiməni; 'testiməuni ]	n.证词
theme	[ θi:m ]	n.主题；题目
theophylline	[ ,θi'ɔfilin ]	n.茶碱
therapy	[ 'θerəpi ]	n.治疗，疗法
thereafter	[ ,ðɛər'ɑ:ftə; ðɛər'æftə ]	adv.此后
thermal	[ 'θə:ml ]	adj.热的，热量的
threshold	[ 'θreʃhəuld ]	n.开端，起点
thrive	[ θraiv ]	v.兴旺；茁壮生长
throne	[ θrəun ]	n.王位；王权
tile	[ tail ]	n.瓦片；瓷砖； v.铺瓦（或瓷砖）于
timber	[ 'timbə ]	n.木材，木料
tissue	[ 'tisju: ]	n.【生】组织（形态上相似的细胞和相关的细胞间物质的集合，如：肌肉组织）
toxic	[ 'tɔksik ]	adj.有毒的
toxin	[ 'tɔksin ]	n.毒素，毒质
tract	[ trækt ]	n.一片（土地）；【解】管道
tragedy	[ 'trædʒədi ]	n.惨事；灾难
trait	[ treit ]	n.特征；特性
transatlantic	[ ,trænzət'læntik ]	adj.横渡大西洋的（轮船、航线等）
transfer	[ træns'fə: ]	v.转移；n.调动；转让
transform	[ træns'fɔ:m ]	v.使…变形；改变
transit	[ 'trænsit ]	n.运输，载运
transmit	[ trænz'mit ]	v.传送（信号）；传播
transplant	[ træns'plɑ:nt; træns'plænt ]	v./n.移栽；移植（器官）
transport	[ træns'pɔ:t ]	v./n.运输，运送
treasury	[ 'treʒəri ]	n.[常the T~]财政部；国库；国库券
treaty	[ 'tri:ti ]	n.协议，条约
tremendous	[ tri'mendəs ]	adj.惊人的；巨大的
trench	[ trentʃ ]	n.沟渠；海沟
triangle	[ 'traiæŋgl ]	n.三角，三角形
tribal	[ 'traibl ]	adj.部落的，宗族的
tribute	[ 'tribju:t ]	n.礼物，贡品
trigger	[ 'trigə ]	n.扳机； v.引发，导致
triple	[ 'tripl ]	v.三倍于；n.三个一组
tri-state	[ 'trai'steit ]	adj.三州（间地区）的
triumph	[ 'traiʌmf ]	v.胜利，成功
trivial	[ 'triviəl ]	adj.琐屑的，微不足道的
tropical	[ 'trɔpikl ]	adj.热带的
truce	[ tru:s ]	n.休战（协定），停战（协定）
tuition	[ tju:'iʃn; tu:'iʃn ]	n.学费
turbulent	[ 'tə:bjulənt ]	adj.狂暴的
ultimate	[ 'ʌltimət ]	adj.最终的，结果的
ultrasound	[ 'ʌltrəsaund ]	n.超声（波）
unbridled	[ ,ʌn'braidld ]	adj.放纵的，无约束的
unconfined	[ ʌnkən'faind ]	adj.未予限制的，自由的
undergo	[ ,ʌndə'gəu ]	v.经历，经受；忍受
underlie	[ ,ʌndə'lai ]	v.位于…之下；成为…的基础或依据
underline	[ ,ʌndə'lain ]	v.强调，加强
underlying	[ 'ʌndə'laiiŋ ]	adj.在下面的；根本的，基础的
undermine	[ ,ʌndə'main ]	v.破坏，削弱
underscore	[ ,ʌndə'skɔ: ]	v.强调
undertake	[ ,ʌndə'teik ]	v.采取；接受
underwrite	[ ,ʌndə'rait ]	v.承诺支付；给…保险
undeterred	[ ,ʌndi'tə:d ]	adj.未受阻的
undue	[ ,ʌn'dju:; ,ʌn'du: ]	adj.过度的，不适当的
unearth	[ ʌn'ə:θ ]	v.出土
unequivocally	[ ,ʌni'kwivəkəli ]	adj.不含糊的；明确的
uneven	[ ʌn'i:vn ]	adj.不规则的，不平坦的
unification	[ ,ju:nifi'keiʃn ]	n.统一；联合
uniform	[ 'ju:nifɔ:m ]	n.制服； adj.统一的；相同的
uninitiated	[ ,ʌni'niʃieitid ]	adj.外行的，缺乏丰富知识的
unionization	[ ,ju:niənai'zeiʃn ]	n.联合，组织工会
unique	[ ju:'ni:k ]	adj.唯一的；独特的
unleavened	[ ,ʌn'levnd ]	adj.未经发酵的
unobtrusive	[ ,ʌnəb'tru:siv ]	adj.不显著的，不引人注目的
unparalleled	[ ʌn'pærəleld ]	adj.无比的，空前的
unprecedented	[ ʌn'presidentid ]	adj.前所未有的，史无前例的
unprocessed	[ ,ʌn'prəʊsest ]	adj.未加工的
unreimbursed	[ ,ʌn'ri:im'bə:sd]	adj.未偿（付，赔）还
单词	音标	释义
unscrupulous	[ ʌn'skru:pjuləs ]	adj.无道德原则的，不讲道德的
unsubstantiated	[ ,ʌnsəb'stænʃieitid ]	adj.未经证实的，无事实根据的
untainted	[ ʌn'teintid ]	adj.无污点的
untenable	[ ,ʌn'tenəbl ]	adj.难以防守的；站不住脚的
unwarranted	[ ʌn'wɔrəntid; ʌn'wɔ:rəntid ]	adj.无根据的
unwieldy	[ ʌn'wi:ldi ]	adj.麻烦的，难处理的
updraft	[ 'ʌpdrɑ:ft ]	n.上升气流
upheaval	[ ʌp'hi:vl ]	n.大变动
upholstered	[ ,ʌp'həulstəd ]	adj.装软垫的
upstate	[ ʌp'steit ]	adj.在州北部的
upstream	[ ,ʌp'stri:m ]	adv.向上游； adj.位于上游的
upsurge	[ 'ʌpsə:dʒ ]	v.急剧上升
urbanize	[ 'ə:bənaiz ]	v.使…都市化
urchin	[ 'ə:tʃin ]	n.海胆
urine	[ 'juərin ]	n.尿
utensil	[ ju:'tensl ]	n.用具，器皿
utilize	[ 'ju:təlaiz ]	v.利用，使用
vacant	[ 'veikənt ]	adj.空着的，未占用的
vaccine	[ 'væksi:n; væk'si:n ]	n.牛痘苗，疫苗
vacuum	[ 'vækjuəm ]	n.真空
vague	[ veig ]	adj.模糊的，含糊的
validity	[ və'lidəti ]	n.有效性；合法性；正确性
variable	[ 'vɛəriəbl ]	n.可变物；变量，变数
varsity	[ 'vɑ:səti ]	n.大学；大学代表队（尤指体育）
vegetarian	[ ,vedʒi'tɛəriən ]	n.素食者； adj.素食的
vegetation	[ ,vedʒi'teiʃn ]	n.植被
vegetative	[ 'vedʒitətiv ]	adj.植物的，有关植物生长的
vein	[ vein ]	n.纹理；矿脉
velocity	[ vi'lɔsəti ]	n.速度；速率
venom	[ 'venəm ]	n.毒液；痛恨
venture	[ 'ventʃə ]	n.（为盈利而投资其中的）企业；冒险事业
verge	[ və:dʒ ]	n.边缘
verify	[ 'verifai ]	v.证明，证实
veritable	[ 'veritəbl ]	adj.确实的，真正的
versatility	[ ,vɜ:sə'tiləti ]	n.多功能性
version	[ 'və:ʃn; 'və:ʒn ]	n.译本；版本
vertebrate	[ 'və:tibreit; 'və:tibrət ]	n.脊椎动物； adj.（鸟兽等）有脊柱的
vessel	[ 'vesl ]	n.船；容器；导管
vestige	[ 'vestidʒ ]	n.痕迹，残余
veteran	[ 'vetərən ]	n.老兵
viability	[ ,vaiə'biləti ]	n.可行性；生存能力
viable	[ 'vaiəbl ]	adj.可行的；能活下去的
vicinity	[ vi'sinəti ]	n.附近，接近
vicious	[ 'viʃəs ]	adj.恶性的
vine	[ vain ]	n.葡萄树；蔓生植物
violate	[ 'vaiəleit ]	v.违反，违背
virtuoso	[ və:tju'əusəu ]	n.演艺精湛的人
virtuous	[ 'və:tjuəs ]	adj.有道德的，品性好的
viscosity	[ vi'skɔsəti ]	n.黏性，黏度
visual	[ 'vizjuəl ]	adj.看得见的；视觉的
vocal	[ 'vəukl ]	adj.声音的；歌唱的
volatile	[ 'vɔlətail; 'vɔlətl ]	adj.易变的，多变的
vortices	[ 'vɔ:tisi:z ]	n.漩涡
wage	[ weidʒ ]	v.发动（战争）； n.工资
warbler	[ 'wɔ:blə ]	n.（能叫出柔和颤音的）鸣禽
warrior	[ 'wɔriə; 'wɔ:riə ]	n.战士
wary	[ 'wɛəri ]	adj.谨慎的，慎重的
welfare	[ 'welfɛə ]	n.繁荣；福利
well-being	[ ,wel'bi:iŋ]	n.健康，幸福；福利
whim	[ wim; hwim ]	n.多变；怪念头
whirl	[ wə:l ]	v.旋转，急转
whisker	[ 'wiskə ]	n.腮须，胡须
wholesale	[ 'həulseil ]	n.批发
wield	[ wi:ld ]	v.支配，掌握
wig	[ wig ]	n.假发
withdraw	[ wið'drɔ:; wiθ'drɔ: ]	v.收回，提取；退出
withstand	[ wið'stænd; wiθ'stænd ]	v.经受住；抵挡，反抗
womb	[ wu:m ]	n.子宫；孕育处
wrap	[ ræp ]	v.包，裹
wreak	[ ri:k ]	v.发泄；引起
wreath	[ ri:θ ]	n.花冠，花环
wreck	[ rek ]	n.失事船只；残骸
wrestle	[ 'resl ]	v.深思
y-axis	[ 'wai'æksis ]	n.坐标轴中的Y轴
yeast	[ ji:st ]	n.酵母
yen	[ jen ]	n.日元
yield	[ ji:ld ]	n.产量； v.产生；屈从
